lơjð | lơið | lơjð | Tón rén
Jơlðk | Jơiðk | Jơjðk | cảm rằm
1ơjueng | Jơjueng | 1Jơjueng | nước bân
1ơk | ñơk | Jơk | xanh (mầu xanh)
Jơmul | šoi | s0i | trỉa (tria lúa, bắp)
Jonap | Jơnap | Jơnap | sung túc
Jơnẽi | Jơnếi | Jơnẽi | giải phóng
lơnẽi | Jơnẽi | Jơnẽi
thắng lợi đại hội | 1ơnăm | Jơnăm | Jơnăm
Jơonũm tch đak | Jonăm teh đak | ]ơnăm teh đak | cộng hòa
J0p | brong | šơ kặt | gùi (cái gùi)
J0p along uñ | 10p along uñ | pũ along uñ | gùi củi
Jơwa | Jowa | ]ơgwa/mơkleng | âm vang
Jrâm | tođung | tơbâp | gặp (gặp nhau)
Jrang | Jrang | Jrang | nhãn (quả nhãn)
Jre | jră | kơtỡ | sảy sảng (lúa gạo)
Jrẽu | Jrều | Jrẽu | háo hức (hoan hô)
jrê | jrê
Jră mi | chống (chống đỡ) cây đa | jri | mm | ]ri | cây đa
Jriđum | ]riđum | ]ri đum | quả đa chín
J1ei | JI e1 | Jriel | cây đa hiện nay
Jruh | tơruih | Jruh | hạ xuống
Jðm dặi | Jöm dã] | ]öm di | xung quanh
Jũm dặr | Jöm đặr | dặr wang | diện tích
Juăt | Juăt | Juăt | quen, thưởng
Juất Jue | JuătJue | JuätJue | quen thuộc
Juãt so | Juăt so | Juầt so | truyền thống
Juãt | Juăt | hmă | quen/thói quen
Jum đặr | Jum dăr | Jum dặr | xung quanh
Jur | Jur | Jur | xuông | 
67