kơdðở | kơodð | kơdð | ngại ngùng
kođồng | kođðồng | kơđðng | cái thúng
kơđoh | kođoh | kođoch | vỏ (vỏ cây)
kođôp tù | kođôp tỉ | kơđôp tỉ | năm tay
kơdră hnam | kơdră hnam | kơdră hnam | chủ nhà
kơdrăt | kơdrăt | kơdrăt | dật mình
kodrâm | kodrâm | kơdrâm | rậm rạp
kơdu | kơdu | kơdu | chạy
kơdũ | kơdũ | kơdð | lưng
kodũng | tũi | tùi | túi xách
kơduêng | koduêng | kơdđuêng | bóng râm
kơšp | koẽp | kơšp | con rêt
koh | koh | koh | chặt (chặt cây)
kơjung | kơjung | kơjung | dài, cao (><ngắn, thấp)
kok | kok | kok | trắng
kokuh | kơkuh | kơkuh | chảo
kơlang kơleng
kơlang kơleng kơleng kơnh
kơlang kơleng | ngăm nhìn
kơleng
kơleng kơnh
nhỉn
kơlih | kolih |kơlh | vì vậy
kơnh | yua | yua | vì, do
kơlð | kơlðk | kơlðk | hộp/cốc (cái hộp, cái lọ)
kơlôš | kơlôš | kơlôš | bao giờ chết
kơmăng | kơmăng | kơmăng | buổi tối, ban đêm
kơmăp | kơmãp | kơmăp | đột quy
kơmăt | kơmặt | kơmăt | mắt, ánh mắt
kơmâng | kơmâng | kơmâng | nghe
kơmar | kơmar | kơmlat | chớp (sắm chớp)
kơmil | kơmil | kơmul | gương (cái gương)
kơmlat | kơmlat | kơmlat | chớp (sắm chớp)
kơmð | kơmð | kơmð | bẩn (đơ) | 
73