đak mi | đak mũ . | đak mi | nước mưa
đak ngom | đak ngom | đak ngom | nước sương
đak rã . | đak ră | đak ră | nứt nẻ
đak ro | đak ro | đak ro | nước chảy
šơdrâm | sơdrâm | cái giếng | đak sơlũng
đaktih | đak tnh | nước lớn | đaktih
rơlat | hlu | nước dâng
đak tk đak toh | đak toh | đak toh | sửa
đah | đah
đah | mọc
hơlch đâng
xong thoản thành) | đang
đang đâng/ vâng
đâng
đâng/ vâng | đâng | từ (tử nav trở đi), của, những
“đâng ataih | đâng ataih | tử xa . | đâng ataih
đang bơnh | đang bơih | đang bơnh | đã xong. .ˆ: am.
đẳng brị | đâng bri | tử rừng... | | đâng brị
đâng đak | | đâng đak | đẳng đak | | vi nước
đâng e1 | đâng noh | | đâng noh | tử đó. tử đáy
đâng lẽ | đâng lẽ | | đâng lẽ | ị | cỏn nhỏ. tử nho
đâng ngc | đâng ngc . | đâng nge | tử bé
đâng rồng | đãng rồng | đâng rồng | sau (đi sau). sau nảy
đâng sỡ | đâng sỡ | đâng sỡ | tử xưa
đâng tu | đâng tu | đâu nguồn | đâng tu
đao | đao | đao | gươm (cái gươm)
đe m | đe | họ. người ta | đe
l1ơmur | 1ơmur | họ tria (tia lúa, bấp) | đe ẽšoi
đe tñðng | đe “ñống - | đe “tñðng | các anh
đe ang | đe ang. | đe ang | họ khen. họ ca ngợi
đe Blan | đe Blan | đe Blan | bạn Blan
đe bôi | đe bôi | đe bội | các bạn | 
48