đe đei | đe đei | đc đei | họ có
đe ga | đe ga | đe ga | họ cầm (cấm việc gì đó)
đe gô | đe gô | đe gô | họ chờ
đe hăp | đe hăp | đe hăp | họ, chúng nó
đe hơdruh | đe hơdruh | đe hơdruh | con gái, người trẻ
đe hơioh | đe hơioh | đe hơioh | trẻ em, thiếu nhi
đe jram | đeJram | đe jram | họ dọn
đe kăk pam | đe kăk pam | đe kăk pam | họ đặt cái đó (cái đó là vật dụng để bắt cá)
đe khul | đe khul | đe khul | nhóm người
đe kon mon | đe kon mon | đe kon mon | con cháu
đe kră | kră | kră | người giả
đc krã sơ | đe kră sỡ | đe kră sở | người xưa
đe mai | đe mai | đe mai | các chị
đe muth | đe muih | đe muïh | họ phát quang
đe nai | prch | prch
người khác họ nghỉ họ làm
đe pơdâi | pơdơh | pơdơh
đe pơm đe potăm | đe pơm đe pơtăm
đe pơm
đe potăm | đe pơtăm | đe pơtăm | họ trồng
đe soh | đe soh | đe soh | họ đắt
đe tơng] | đe tơng!l | đe tơnG! | người lãnh đạo
đeư | đe'ngă | đe hưế | khen ngợi
đeuư | đeu | đe ư hơñang | người ta khen
đe ư ang | đe ư ang | đe ư ang | nổi danh
đế | đẽš | đềš | thôi (cho không thôi)
đềl | đẽl | điê] | dấu vết
đei | đei | đei | có, được
đei bar | đei bar | đei bar | có hai
đei đâng | đei đâng | đei đâng | có từ
đei đon | đei đon | đei đon | có ý tưởng | 
49