gơh | gơh | gơh | được (sẽ, biết)
gơh băt | gơh băt | gơh băt | nhân cách
gơh bặt | gơh wao | gơh lễ | hiểu biết
gơh gai | gơh gai | lặp gal | vừa, vừa vặn
gơh rogel | gơh rơgei | gơh rơgei | giỏi dang
gơh wih | gơh brốõk | gơh brðk | mới về
gơh yua | gơh yua | gơh vua | có ích
goi goi gâng | kơ`mâng goi gâng
kơ` mông | ngọn, mâm
goi gâng | goi gâng | goi gâng | ngọn cây nêu
goi hla along | goi hla along | gọi hla along | ngọn cây
gOIJT | goi]ri | along]ri | cây đa
gơlũng | gơlũùng | golũng | lũ lụt
gơlũng | gơlùng | golũng | tấn công
gơnðl | gơnã] | gơng] | nhận ra
gơng “nao | kơtua`nao | bor “nao | cái câu mới
goning | gơning | gơning | dâng (tựa vào)
gram | gram | gram | đọn (dọn rẫy)
grâm | grâm | grâm | sâm
grang | rang rch | lăn | rỗ xúc cá (loại nhỏ)
grê | grÊ | grê | nghiêng, xiêu
grẽñ | grẽñ | grẽñ | nhe răng (gầm gử)
Đgrỡ | grỡ | BTỜ | con chim kên kên
grỡ akhan | grỡ akhan | grỡ akhan | kên kên nói
groi | groi | groi | đồi, đổi núi, đất trên cao
găm | gũm | gũm | giúp (giúp đỡ)
gũm bă | găm bă | gũm bă | giúp cha
gũm mẽ | gũm mẽ | gũm mš | giúp mẹ
guăng | alâng | liềm | đẹp
hãi | hãi | hãi | khát (khát nước)
hãi | hãi | kơlok | khát nước | 
53