brê ẽah | brê šah | đo ong anh
bre añðng oh | bre añðống oh | hai anh em
sêh săh | brêh brah | tung tóc
bre hăp | bre hặp | họ, hai người
bre vă sau | bre yã sau | hai bả cháu
brẽ | brš | biền biệt
brẽñ | brẽñ | brenh (tên con chó)
vâng bri/brei brem bri | Hơbi/brei brem bri
hôm qua thú (thú rừng) | brem | brem
brem thủ (thú rừng) bri rửng | bri |bri | rửng
bri along | bri along | rửng cây
bri kông | bri kông | rừng núi
briơi | briơi | rừng ơi
bri rơng | bri rơng | rửng rậm
wih | wih | về
vong
hơkăt bui | gùi (cái gùi) bụi (bụi bắn) | bui | bui | bụi (bụi bần)
bẽ kiơ
bẽ
nảo, đi ai, gì | kiơ | bu | ai, gì | bu
bu | bu | ai
sðk hơbo | sốk hơbo | râu bắp
buưh bưh | bưh bưh | mãi mãi
bum greu | bum ngô | đậu phộng
bung bang | bung bang | hoa sim
bai | bai | bải
bak | bak | trắng (<đen)
beñ | beñ | đây (làm đầy)
blang blang | blang blang | đan sen (nở ra)
bôñ | bôñ | đễ (dễ dàng)
bôh | boh | thấy (nhìn thấy) | 
39