kơpal | tơ koñð | kơpal | ở trên cao
kơ phẽ sa | kơ phẽ sa | kơ phš sa | . hái ăn
kơ rim anu | kơ rim anu | kơ rim anu | mọi người
kơtâng | kơtâng | kơtông | nghe
kơ the đak | kơ the đak | kơ the đak | cho đất nước
kơtuă | tơtuä | tơtuă | gần gũi
kơ uñ hnam | kơ uñ hnam | kơ uñ hnam | „cho gia đình
kơ | kơ | kơ
từ chỉ trợ tử con chó | kð | kð | kð
kð Brang | kð Brang | kð Brang | chó Brang (tên con chó)
kð so | kð so | kð so | chó sói
kơšðl | kơšăšl | kơjă] | thời trước
kơšâp | šâp | Cập | gấp lại
kơšâp | košâp | košâp | xếp (xếp, gấp)
kơ?ñal | moñal | moñal | sáng chói
koñang | koñang | mơ”nar | chói
koñang | koñang | kơñang | T vang vọng
koñong | kơñong | koñong | cuôi củng
kơ ãữ | tơñửi | kơpal | ở trên
kơ`nợp | kơ”nợp | kơ`nợp | trú (ẩn núp)
kơang | košéăäng | košăng | chú ý
kơ-ang alâng | kơ-ang alâng | kơ-ang alâng | khoe sắc đẹp
kơdïm | kơdïm | kơdïm | hành (lá hành)
kơdăng | rơdang | kơdang | căn cối
kơdâu | hluh | hluh | chạy
kođch | kơđch | kođch | ngắn (ngắn >< dài)
kơdih | kơdih | kơdih | bản thân, cá nhân
kơdih ïñ | kơdih ïñ | kơdih ïñã | tự tôi
kơdih oh | kơdih oh | kơdih oh | bản thân em
kơdơ | kơdđơ | kơdơ | cánh đồng | 
72