Jur wih | | Jur wih | Jur wih | quay về
ka | ka | ka | cá
ka hơla | ka hơla | ka hơla | cá ở đưới (nước)
ka lẽ | ka lẽ | ka lề | cả nhỏ
ka phê | ka phê | ka phê | cả phê
katih | katth | katih | cá to
kăk | kặk | kăk | đặt, bẫy
hrðk | hrờk | hrờk | cải đơm bắt cá (loại nhỏ)
kăi | kăi | wä | cân, đê
kăi | kăi | kăi | cần thiết
kăl hloh | kặ] hloh | kăl hloh | hơn hết, quý hơn
kăm | kăm | kăm | thưởng
kăn | kăn | kăn | vợ
kăn hăp | kăn hăp | kăn hặp | vợ nó
kặp | kặp | kặp | căn
kặp gĩït kãt kâi
kặp gặt
kấp gĩt kãt
quý giá, giá trị
kặt kất kãt kâi kâi kâ]
kặt
cắt (cắt thịt) đầu (cái đầu) thêm khát | kâi kâi kâi đầu (cái đầu) kăi 1âl lơhing lơhing thêm khát | kâI jâI lohing | kâ] lơhing | kăi | ]âl lohing !lơhing | lơhing | thêmkhát
kâl angðk | kâ] angðk | kâl angðk | đâu óc
kâm | khoi | diềng | kiêng cữ
kang | hang | kang | cảng (ngày cảng nhiều)
kang bô | kang bỗ | kang bỗ | cán bộ
kang năr | kang năr | kang năr | cảng ngày cảng
kao su | kao su | kao su | cao su
kẽš | kẽš | kếš | tuất (tuốt lúa)
keh | đang | đang | xong (hoàn thảnh)
kem | kem | kem | tôn
keo | keo | keo | kẹo
khĩn | khĩn | khĩn | gan dạ | 
68