đơđuk | đơđuk | đơđuk | nặng trĩu
đon | đon | đon | tại, suy nghĩ, ý nghĩ
đon bơnôh | đon bơnôh | đon bơnôh | cảm động
đon kơdih | đon kơdih | đơn kơdih | trí nhớ, kỉ niệm
đon mẽ bă | đon mẽ bă | đon mẽ bă | tấm lòng của mẹ cha
đon tơöšng | đon tơẽẽng | đon toššng | suy nghĩ
đum | đum | đum | chín (quả chín)
li | e
ut mai 'lâng
mầy (tao)
e guăng | e guăng | chị đẹp
ehăm | chăm | ehăm | bạn có
ciốk | elðk | elðk | em lấy
© TÔp | e rôp | © rÔp | bạn bắt
ẽi | ẽi | ẽi | đó (đấy)
el | ei | 6l | ấy
et | ñã | €t | uống
etsa | etsa | etsa | nhậu nhẹt
et tk hnam | et tk hnam | ettðk hnam | lên nhà mới (tân gia)
gĩt | gặt | git | quý (quý trọng)
gĩt gă] | gĩït găi | gĩt găi | giá trị, quý giá
gĩt wă | gït wš | gĩït wš | quý trọng
ga | ga | ga | ngăn cản
ga khan | ga khan | ga khan | trả lời
găi | găi | gă] | khoảng (khoảng vừa)
găn | găn | găn | ngắn (><dải)
gặr ba gšT | găr ba | gặr ba | hạt lúa
gah | gah | gah | phía (phía trước, sau), bên, về (phía)
gah hơlšš | gah holẽš | gah holẽš | phía đông
gah kơpal | gah kơpal | gah kơpal | phía trên, bên trên
gah to | gah to | gah to | bên kia | 
51