hơtor | bơlơk | bơlơk | nhánh (nhánh chuối)
hơbâi | hơbâi | hơbay | rau cải
hơblh | hơbhh | iơblh | thay đổi
hơbo | hơbo | bơbo | bắp (quả bắp)
hỡ | hơt | hơt | cay (ớt cay) gx& (4ˆ
hðờk | hỡk | hốk | học (học hành)
hỡk | hỡk | hðk | cảm động
hỡk pơhram | hök pơhram | hỡk pơhram | học tập
hốk tro | hốk to | hðk tro | học sinh AEz $
hoẽš | hošẽ | hoš | Tút (rút ra)
hơšăng | aẽăng | tơ'nglai | thải đoôi
hoẽšô | hơẽšô | hơšð | bó ì
hơña | hơña | hơña | cái vó
hơñông | hoñông | hơñông | hò hát
hỗ lah | hồ lah | hỗ lah | trời ởi
hơmon
hơ mon hơyuih
hơ'mon
kế (kể chuyện) ướt không
hơañunh
hơyuih “yôm ướt ưh ưh không
“yôm
hoai | ưh | ưh
hơanâr | hơanâr | sơ nâr | thức dậy
hơbal | hơbal | hơbal | nhanh như gió
hơbâu | hơbðu | hơbðu | con ôc
hơbê hơbah | hơbê hơbah | hơbê hơbah | sum xuê
hơbšš | hơbẽš | hơbšš | nhanh nhẹn
hơbšš ưh | hơbšš uyh | hobšš ưh | nhanh nhẹn không
hơbšn | hobến | hobšn | quân
hơbẽn ao | bơbẽn ao | hơbẽn ao | quân áo
hơbeñ | hơbeñ | hơben | váy, quân
hơblh | tơphh | tơphh | đổi (thay đổi)
hơbhh “nao | tơphh “nao | tơphih “nao | đối mới | 
~x 57