soh | soh | soh | đốt (đốt lửa)
soi | so1⁄/ sơmah | sơmah/ cuai | cúng (cúng bái)
sơke | hơke | hơke | cái sửng
sơke | sơke | sơke | heo rửng
sơkũng | sơkũng | sơkũng | mỏ (cái mỏ, môi)
sơlam | solam | sơlam | giữa (ranh giới)
sơleng | sơleng | sơleng | mù tịt
sơlũng | sơlũng | sơlũng | cái hỗ, thung lũng
sơlũng râm rẽk | sơlũng râm ršk | sơlũng râm rẽk | hô rác
sơmš truh | sơmă truh | sơmã truh | cứ đên
sơmah | sơmãt/ sơmaih | sơmat/ sơmaih | cầu khẩn
sơn | sơn | hơnă | nền tảng
sơnăm | sơnăm | sơnăm | năm (tuổi)
sơnăm | sơnăm | sơnăm | năm
sơnăm âu | sơnăm âu | sơnăm âu | năm nay
sơnenh | sơnenh | sơnenh | răng (cái răng)
sơnêp | sơnêp | sơnêp | yên (ngồi yên)
song | song | song | cho (cho vào)
sơng lặk | sơng lðk | sơng lðk | đón
sơng iðk | sơng lðk | sơng lðk | đón tiếp/đón nhận
sơnong jang | sơnong jang | sơnong Jang | nhiệm vụ
SOT | SOT | tơk | rọi (SOI TỌi)
sơsuak | sơsuak | sơsuak | chớp nhoáng
sơsueng | sơsueng | sơsueng | mùi vị
sơsuinh | sơsuinh | sơsuinh | luân quần
sử | sử | sử | đề (đề lại)
suai | suai | suai | say (say rượu)
suang | suang | suang/ kơdôh | múa (nhảy múa)
suek blek | sĩk mu] | hi | bực tức
suẽng | "ñueng | suẽng | nhọn hoắt | 
104