kha | kha | pha | khác (khác nhau)
khăm | khăm | kham | khám (khám bệnh)
khan | khan | khan | nói, khuyên bảo, gọi, nhắc nhở
khan 1ñ | khan 1ñ | khan 1ñ | nói với em
khâr | ngân | ngợr | ) ợm h (nghịch ng: nghịc
khẽ. | truh | truh | đến
khei | khơi | khei
tháng mặt trăng | khei : | mặt khei | khei
khei s | khei 8 | khei 8 | tháng 8
khei 9 | khei 9 | khei 9 | tháng 9
khei alâng | khei alâng | khei alâng | trăng đẹp
khei ang | khei ang | khei ang | trăng sáng
khei ei | khei ei | khei eï | tháng này
khei năr | khei năr | khei năr | tháng ngày
khei pêng | khei pêng | khei pêng | tháng 3
khei pơni] | khei pơni] | khei pơnil | trăng rằm, trăng trỏn
khei puih khei tơbang
khei puih | khei | tháng của mùa thu
khei tơbang | khei tơbang | trăng khuyết
khêl | khê] | đao | kiếm (cái kiếm)
khê] | khê] | khêl | lá chắn
khin pran | khin pran | khin pran | thể lực
khốm | hơdrin | hơdrin | cô, cô găng
khốm keh | khốm kch | khốm kch | cố hết sức
khôi juất | khôi luất | khôi Juăt | truyền thống
khok | tơplẽng | khok | măc/măc cô
khom hơdrim | khom hơdrin | khốm hơdrin | quyết tâm
khong | khong | “khong | vật (đồ vật)
khong pũ | bron g brai | | brong brai | cái gùi, túi vải (đồ mang, gùi) | 
69