ami ẽruth | am šẽrunh | mưa đồ
ami hngaš | ami hngaš | mưa dâm
| ami prel | ami prel | ! mưa đá
| boi | | boi | | theo mm
| amẽh | | “moih | | muốn, thích
| amui | |bruih | bụi bặm -
lăn | lăn | | cho (cho đưa)
| ăn kơ | | ăn kơ
cho, cấp, phát cho cho học, cho tập tình | Từng (mửng rỡ) | | ân răm x- ană | ăn răm | hưế | “nã | hưế | | hưế | Từng (mửng rỡ)
anăk | “anăk | đặt
anăk hơkap | anăk hơkap | đặtbẫy -
mặt | mặt | tên (tên người)
anăr dâng | “năr dâng | buổi trưa
anär lẽš | anär lẽš | phía đông
anăr mật | anăr mât | mặt trỏi lặn, phía tây
anao | anao | mới
anao lšš ang | anao lẽš ang/ hơgah
Thới ra
ang | ang/ hơgah | sáng, ánh sáng
ang mơnă | ang mơoñă | khoe sắc
angam angam | angam angam | ngọt
anguaih | agah | ngoải (2<trong)
hơnnh | amh | chỗ (chỗ ở)
anoh | anoh | đấy, đó
lu | lu | những, các (những người)
anu anð | anu anð | thế nảy, đâu đó
anu bơngai | anu bơngai | người (một người)
anu kon | anu kon | người con
anu yang | anu vang | người thần
ao | ao | áo (cái áo) | 
33