~ z
SE HE EZVUR BƠ ERHơNH EW GHẾ HN mINNZEBE
¡ SH Xu? HS RE N Em k  Ñ
Bahnar | nhóm 2
Tiếng Việt | Kon Kơđeh, Bơnâm | Krẽm
aöăng | aöăng | thả (thả ra)
aềèăng lề | aềăng lê | buông thả
aẽăng tí | aðăng ti | thả tay, buông tay
ba | hnuk | mang theo
anhăk | dră tð | phơi nắng
añăk phe | añäk phe | chuyển lúa
añao | añao | rửa (rửa mặt, tay)
añẽt | añết | cỏ
añik | añik | cuốc (cái cuốc)
añõng hăp añơk
añðng hp | người anh
añơk | xanh (mầu xanh)
añot | añot | rau
bâi | bâr | tiếng
adrĩh | hơdnh | tươi, sông
adrăl | adrặ! | bất tử (tỉnh táo)
adrẽš | adrẽš | dân tộc, giống
adrẽš bahnar | adrẽš bahnar | dân tộc bahnar .
adrếng | adrẽng | chiên, xảo, rán
SỬ | sử | đề
ah | ah/ gơning | dựa, nhờ (tựa)
ah | bơih | TÔi
ah | ah | hả
ah along | ah along | gốc cây | 
3i