khu! | khul | khul | nhóm, đội, hội, đám
khul kon pơlei | khul kon pơlei | khui kon pơlei | cộng đông
khul kră | khul kră | khul kră | hội người cao tuổi
khu] sem | khul sem | khul sem | đản chim
kial | kial | kia] | gió
kiếng | tiếng | tiếng | cái đuôi
kiek | kla | kiek | con hô
kiơ
kiơ TJŠ jih/ hãn jih | kiơ ]ễ jih/ hăn jih
gì (vâng)
kiỡ jih | Jềjih/hãnjh  jễ jih/ hăn jih | gần vỉa hè (vỉa hè)
kiơ ăi | kiơ ei | kiơ ei | gì vậy, gì thế
kiơ hei | kiơ hei | kiơ hei | sao vậy, sao thê
kiỡ todrong | kiỡ kơ tơdrong | kið kơ tơdrong | tủy vảo công việc
kiơ yao | kiơ yao | kiơ vua | vì Sao
kiỡ | kiở | kiỡ | theo (đi theo). dọc theo
kiở | kiä | tiỡ | theo
kiở kơi | kiở kơi | kiỡ kơi
theo như... con nhái con ch | kit kit kơ pô
kưt | kưt
kit kơ pô | kưt kap | kưtkêh | con ch c | kưt kap | kưtkêh
kla | kla | kla | con báo
klã | klă | khă | rắc (chỉ tiếng động)
klah song | kiah song | klah song | chia nhau
klath | klath | dă dã | đỡ/ bớt
klaih | klaih | klanh | khỏi, thoát, lảnh
klaih | klaih | đơng rõng | sau (đi sau)
klaih đâng ami | klanh đâng ami | klanh đâng ami | thoát khỏi tử mưa
klaïh ]ram | klanh jram | klaih Jram | dọn xong
klath kơ anoh | klaih kơ anoh | klath kơ anoh | sau đó
klath soh | klanh soh | klainh soh | đất xong
klak | klak | klak | bụng. ruột
klăn | kiăn | kiăn | con trăn | 
70