hơtăk | hơtk | hotăk | kém
hơtũk | hơtùk | hơtốk | luác rau
hơtũk tơpš | hơtùk tơpă | hơtÙk tơpšă | kâm quá
hơtũữm | hơtăm | tũm | ao hỗ
hơtữm | hơtữm | kơtữm | họ hàng
hơtuš | hơtuš | hơtuš | cuối kết thúc
hơwäl | hơwäăl | hơwäăl | bận rộn
hơwan | hơwan
hơwan hơwât | đoạn tai vung tay | hơwât | hơwât | hơwât vung tay
hơsẽng | poliẽng | pơliẽng | làm sạch
hơnsi | hơsi | hơsi | gáy hót kêu
hơsi ššk ššk | hơsi ššk ššk | hơsi ššk ššk | hót chéc chéc
h{suang | h{suang | h{suang | múa
hơyũùn | hơyũn | hơvyùn | nhún nhún múa
hơyuh | hơyuh | hoyuh | bão gió
hg yuih | yôm | hơ “ñunh | ướt ưăt đẫm
hră | srã | sră | cái nh cái ná
hnâm ẽi | hnâm ẽi | hrâm ềi | lúc ấy
hrâm hrâm | hơdainhơdai | hơdainhơdai | nhịp{nhảng
hrâp | srâp | srâp | đậu châm đậu
hrâp | hrâp | hrâp | mặc màc áo
hrat tơnat | hrat tơnat | hrat tơnat | vật vả
hre | hre | hưc | cây mây
hrẽng | srieng soreng | srieng | khô phoi khô
hreš klo kăn | hreš klo kăn | hreš klo kăn | ly hôn
hrêa hrao | hrêa hrao | hrêa hrao | khẳng khiu
Hrit | Hrtt | Hrit | tên rờêng hrit
hrð | hrõ | hrõ | vơi đíy xẹp
hrỡ | hrỡ | srỡ | cạn nhớc cạn
hrônh | srôih{hrunh | srôih | sớm sang sớm | 
63