tơ kơpa] añếšt | tơ kơpal añẽt | tơ kơpal añết
trên ngọn cỏ lắng nghe | tơ mâng | tơ mâng | tơ mâng
tơmurna | tơ lir na | tơ lir na | trên rẫy
tơna | tơna | tơna | rg đồng
tơ{pơbah | tơ{pơbah | tơ{pơbah | cuôi sông
tơ oreñ | šơ?ñut | šơ"ñut | nhăn tóc xoăn
ti rông | ti rông | ti rông | tại nhả rông
tơ sah | tơ sah | tơ sah
xã trưởng | t{ rung | tơ trong | tơ trung
tơbăng | tơbăng | tobăng | măng
tơbăng | añot, añem | ñot, ñcm | rau thịt
tơbắp | râm tơbâp | tơđung tơbâp | gặp gặpngỡ mm
qobla | tơbla | tơbla | cảnh
tơbôh | tơbôh | tơbôh | chỉ thấy cho thấy
tð | tổ | tð | nóng năng
tờ ang
tố ang tờ kia | tõ ang ti kial
ảnh nhng
tðồ kial | tờ kia ti kial | nắng gió
tð pơẽang — | tố pơlang | | tồă pưẽšang | nắng chói chang
tốk . | | xuðn/ tốk | hao thk | lên lên{xuống
tờk | tk | tớk | soi sơi rọi
tk bök | tek bốk | tốk bðk | trung tâm giữa dòng
tk bðk | | šokhôt | | to"ñửi | trên rao
tõsẽt | kơtuei | | biỡ | ít nhiều
tôš | | tôẽ | tôš | quá đau qtá hết
| tôš lẽ | tôẽ tế | tô lẽ | qcá nhỏ
tơẽar kông | tơếar kông | tơẽar kông | tây nguyên
tơẽât | tơẽât | toèât | hứa hứa hẹn
tơèšng | tơẽšng | ẽro | suy nghĩ
tơẽšng rah | tơššng rah | tơöšng rah | vừa vửa nghĩ | 
108