bơ | bơ | cá lóc loại nhỏ
pơm jang | dpơm ang
lâm đắp đắp bở | bỡ | bỡ
bi brai | bi brai | dệt vải
b̆ jang | b̆ jang | lao đang
bi khốm | bỡố khốm | cổ gắng
bỡ sơlung | bỡ sơlung | đảo hồ
bỡ mir | bỡ mir | làm ray
bỡna | bỡna | làm{ruông
bỡ găn | bỡ găn | ngăn ngăn dòng nước
böjang | bỡ jjang
lao đang sản xuất đục tạc khoét | | bök | bðk
bối | bối
hũ vại cái hũ làm việc đi
bỡjang | bỡiang
| năm | | năm
bốk găn | bốk găn | đi qua
b̆k ang | năm ang | đilảm
bốk tơ kông | bốk tơ kông | đi lên rửne vào rửng
bơang | bơang | khoe khoang
bơbăh | bơbăh | hướng bắc
b{brơng | b{brơng
năm dai xúc bùn mái mái nhà mái mái nhả mỗ hôi rồi
bơbÙk | bơbữk
bơbũng | bơbũng
šơkup | pơdah
bơbuh | bơbuh
bolh | bơnh | bơnh
boih | ôh | bơnh | đâu rồi
bơnh | bơnh | bơnh | rồi xang rồi
bơïh pố | bơih pŠ | btih pỗ | tôi ban
bôk | năm | vak | đi bước đủ | 
37