ị tơtặ] | tơtăi | tơtă] | quyến luyến
l tơtch | kơtch | sơmreh | tiếng động
tơtinh | tơunh | tơtinh | tư duy
“tOtð | totð/ totð | tơtð/ tơtð | ấm áp
tơtôh | tơtôh | tơtôh | thúc dục
tơtom | tơtom | tơtom | kịi thời
tơtũ] | tơsil | dơjil | đụng đhạm
tơtuh
tơtuh tơtuh | tơxi{tơtnh | kêu hat vỗ phủi | tơtuh | tơtuh {tơtnh | tơtnh vi phủi
tơtul | tơsil | tơbeng | tông vư chạm
tơwlr | solỗ | sơlỗ | áo thuật
tơwaih | tơ oalh, hơkš | TšU | gùi nhỏ
tơwât | tơwât | tơwât | vải làn
tơwnl | tơwil | tơwil | tròn hìng tròn
tơsĩ | tơsĩ | kơsĩ | đồ nước đồ gạo đồ
tơsïn | tơsĩn | tơsïn | số chín
tơsïn tð | tơsïn tð | tơsïn tð | 9cái
tơsât lêu | tơsot jêu | tơsệt jên | tttiền
tơyơ | tơyơ | tơyơ | ở đâu
trah | trah | trah | đếo để cây
trăp | hungăm | trăp | nặng
trng | trăng | trăng | cái chn uống rượu gè
trõ | trõ | tr | đâm vào chác vào
trôm | trôm hơdrăng | trôm hơodrăng | lm hang
trong | trong | trong | dỏng đường đưởng cái bộ
trong groi | trong groi | trong groi | trên đồi
trơwơ | trơwơ | trơwơ | hạt kê
truh | truh | truh | đến .
truh ang ci | truh ang ei | truh ang ei | đến nay | 
113