~ z
SE HE EZVUR BƠ ERHơNH EW GHẾ HN mINNZEBE
sh xumhs re em
bahnar | nhóm 2
tiếng việt | kon kơđeh bơnâm | Krẽm
aöăng | aöăng | thả thả ra
aềèăng lề | aềăng lê | buông thả
aẽăng tí | aðăng ti | thả tay buông tay
ba | hnuk | mang theo
anhăk | dră tð | phơi nắng
añăk phe | añäk phe | chuyân lúa
añao | añao | rửa rửa mệt tay
añẽt | añết | cỏ
añik | añik | cuốc đái cuốc
añõng hăp añơk
añðng hp | người anh
añơk | xanh mầ{ xanh
añot | añot | rau
bâi | bâr | tiếng
adrĩh | hơdnh | tươi sông
adrăl | adrặ! | bất th tỉnh táo
adrẽš | adrẽš | dân tic giống
adrẽš bahnar | adrẽš bahnar | dân tic bahnar
adrếng | adrẽng | chiêngxho rán
SỬ | sử | đề
ah | ah gơning | dựa nhờ tựa
ah | bơih | TÔi
ah | ah | hả
ah along | ah along | gệc cây | 
3i