thn krưp | tíh kaựp | tỉh kaựp | to cao
tim {ă ènh | sang nh | l đim ẽ¡h | chưa tiết
to | to | to | kia kaa
tơbăng | | añot | | añot | | Tau
| tơẽam | | tơö am | | toẽam | trên ngoài sân
| tơ šar brị kông | tơ éan b̆ kông | tơ ẽan br̆ kông | trên đồi núi
| tơẽšẽšng | | Ốro | | ẽšro | suy nghĩ
tơñãk | tơñăk | | tơñăk
mang đi đấy đây | tơnoh | | tơnoh | | tơnoh
tơ añãk | tơ añãk | tơ añăk | chuyển đổi
tơ ala | tơ ala | tơ ala | ở dưới
tơ along | tơ along | tơ along | trên rây
tơ atnlh | tơ atnnh | tơ atnth | ởxa
tơ đak | tơđak | tơ đak | dưới nước
ti đơng | ti đơng | ti đơng | trên rạn
tơgoi ũ | tơgoi tì | tơgoi t | trên ngọn cây
tơ hnam | tơ hnam
tơ hnam tơ hnam nao | nhà nhà mới
tơ hnam nao tơ hnam trưng | tơ hnam nao tơ hnam trưng
tơ hnam nao nhà mới
tơ hnam trưng tơ hnam trưng | tơ hnam trưng | đến thưởng
tề hơnê | tề hơnê | tề hơnê | ở giữa
tơ hơtaih | tơ hơtaih | tơ hơtalth | ỚỞxa
ti hroi | ti hroi | ti hroi | nôi đuôi nhau
tơ iung | tơ iung | tơ iung | dựnglấn
tơjê | Jrât jrăt eï | tojê | san sãt
tơ jih šam | tơ jih šam | tơănh am | bên cạnh sân
tơ jrnm | tơjrỡm | tơbỡởp | gặp gaư nhau
tơ klah | tơ kinh | tơ klah | chia tễ
tơ kăn tum | tơ kăn tum | tơ kăn tum | kăn tum
tơ kông | tơ kông | tơ kông | trên núi
tơ kơpal | tơ kơpal | tơ kơpal | ở trên | 
107