ami{ẽauth | am šẽrunh | mưa đồ
ami hngaš | ami hngaš | mưa dâm
ami pơel | ami pơel | mưa đá
| boi | | boi | theo am
| amẽh | | “moih | muốn{thích
| amui | |bruih | bụi bơm
lăn | lăn | cho cho đưa
| ăn kơ | | ăn kơ
cho chp phát cho cho học cho tập tình từng mửng rỡ | ân răm ană | ăn răm hưế | nã hưế | hưế thng màng rỡ
anăk | “anăk | đặt
anăk hơkap | anăk hơkap | đặtbẫy
mặt | mặt | tên tờn người
anăr nâng | năr dâng | buổi }rưa
anär lẽš | anär lẽš | phía đông
anăr nật | anăr nât | mặt trỏi lặn ph a tây
anao | anao | mới
anao lšš ang | anao lẽš ang{hơgah
thới âa
ang ang{hơgah | sáng ynh sáng
ang mană | ang mơoñă | khle sắc
angam angam | angam angam | ngọt
anguaih | agah | ngoải trong
hơnnh | amh | chỗ chỗ
anoh | anoh | đấy đó
lu | lu | những các những người
anu anð | anu anð | thế nây đâu đó
anu bangai | anu bangai | người một người
anu kan | anu kan | người con
anu yang | anm vang | người thần
ao | ao | áo cái áo | 
33