kơpal | tơ koñð | kơpal | trên rao
kơ thẽ sa | kơ thẽ sa | kơ phš sa | hái ăn
kơ rên anu | kơ rên anu | kơ rên anu | mọi người
kơtâng | kơtâng | kơtông | nghe
kơ the đak | kơ the đak | kơ the đak | cho đấy nước
kơtuă | tơtuä | tơtuă | gần gài
kơ uñ hnam | kơ uñ hnam | kơ uñ hnam | cho gia đình
kơ | kơ | kơ
từ chỉ trợ tử con chó | kð | kð | kð
kð Brang | kð Brang | kð Brang | chó brang tên con chó
kð so | kð so | kð so | chó sói
kơšðl | kơšăšl | kơjă] | thời trước
kơšâp | šâp | Cập | gấp lại
kơšâp | košâp | košâp | xếp xăp gấp
kơ?ñal | moñal | moñal | sáng chói
koñang | koñang | mơ nar | chói
koñang | koñang | kơñang | vang vọng
koñong | kơñong | koñong | cuôi đủng
kơ ãữ | tơñửi | kơpal | ở trên
kơ nợp | kơ nợp | kơ nợp | trú ăn núp
kơang | košéăäng | košăng | chú ý
kơ ang alâng | kơ ang alâng | kơ ang alâng | khoe sắc đẹp
kơdïm | kơdïm | kơdïm | hành tá hành
kơdăng | rơdang | kơdang | căn cối
kơdâu | hluh | hluh | chạy
kođch | kơđch | kođch | ngắn ngắn dài
kơdih | kơdih | kơdih | bản thân cá nhân
kơdih ïñ | kơdih ïñ | kơdih ïñã | tự tôi
kơdih oh | kơdih oh | kơdih oh | bản thân em
kơdơ | kơdđơ | kơdơ | cánh đồng | 
72