rong | rong | rong | nuôi
rơngei | Tơng€i | rơngei | hòa bình
rơngơp | rơngợp | lơngợnp | mát mát mẻ
tơngơp | rơngơip | rơngơp | bóng vát
rơngũa | rơngũa | tơngũa | văng vẻ
TƠnð | anih | dơnð | chỗ chỗ
rơnơh | hơdrân | rơnơh | cái liêu
rơngh | rơnơh
rơnơh}rơnôp | túp lều búp hoa | rơnôn | rơnôp | rơnôp búp hoa
rôp | rôp | TÔp | nắm bắt
rốp{kơ ne | rôp{kơ ne | rôp{kơ ne | bắt chuột
rôp păng kð | rôp păng kð | rôp păng kð | sử dụng con chó để bắt chuột
rơpang | rơpang | rơpang | quả cả rừng
rơtk | rorik | TƠTÏk | ham hồ
rOră | TØTă
rơrä rơrck rorenh | đau xót tức khắc run rẩy tả ngưọi nhỏ
rorek | rorek | rơrck tức khắc
rorenh | rorenh | rorenh run rây tả ngưọi nhỏ
rorinh | rorinh | rơrimh | run rẩy tả người lớn
rơtah | rơtah | rơotah | con đểa
rơtăp | pơtep | pơtep | nối nói liền nhau
Tơ-UƠ | TƠ-UƠ | TƠ-UƠ | cây bừa
Tơwïn | Tơwïn | rơwin | nông nội
rơwăn | rơwăn{rơhơi | rơwăn{lơhơi | rảnh rỗi
ruth | ruih | ruih | đồ vào tưới
Tup | um | hĩn | hình hình ảnh
sĩk | sĩk | sĩk | rượu gẻ
sa | sa | sa | ăn
sa kơne | sa kơne | sa kơnc | ăn chuột
sa sĩn | sa sĩn | sa sĩn | ăn chín | 
101