kơtao | kơtao | kơtao | mía
kơthơ | kơthơ | kơthơ | lá thư
kơung | kơnng | kơting | xương
kơtoh | kơtoh | kơtoh | nhn giọt
kơtơh ˆ | kơtơh | kơtơh | ngực
kơiol | hơtol | hơtol | treo
kơtrð | kơtrð | tr | đúng đúng sai
kơm kơtuãi
kơm | kơm | làng{hoang
kơtuãil | ki tuôi | cục chc đất
kơtuh | kơtuh | kơtuh | cái th vi phủi
kơtul | kơnm!l | kơtul | lạc hậu ngu
kơtuơ | gơng | bor | cái câu
kơwonh | kơwoinh | kơwơnh | váy gọi
kosð | kơsðở | kosð | chiều buổi chiều
krg krũt | kră{krunh | kră{krunh | giả côi
kră
kră kră{pơlei | kră kră{pơlei
giả giả cả
kră{pơlei | kră pơlei krã{pơlei | giả làng
krâš krăš kram | krâš krăš kram
krâš krăš | cg đồng
kram kram | kram | tre cây tre
krang | krang | krang | dốc đường đốc
krang | krang | 1ơger | dốc đác đèo
krao | krao | krao | gọi kau gọi
krao lðk | krao lðk | krao lðk | kêu lay gọi lấy
krê | krê | krê | nguy hiểm
krê kơơ | krê kơơ | vă kiơ | cái gì
kro | kro | | kroh | khô coy khô
| krðng | krống | | krõng | thức khuya
| krôm | | krôm | | krum | gầm bản
| krong | | krong | | krong | sông dòng sông sông ba
| krông | | krông | | kông | núi | 
76