hơdruh | hơdruh | hơdruh | con gái {hụ nữ
hơdruh ši | hơdrun ẽi | hơdrun ẽi | cô nầy cô ây
hơdrun mă yơ | adruh mã vơ | adruh mă vơ | phụ hữ nảo
hơdrun rôp | hodrŭ rôp | hơdrun rôp | đuổi đắt
hơdrunh | šơdruih | s{druih | chối cái chổi
hơdu | hơdu | hơdđu | cái dù
hoe | hoe | ngõ
quay nhìn gâm bản giưởng | hơgâm | kơrôm | korôm
hogâm | hogâm | hơgâm | nếu mà
hơgâp | kơiêp | kơiep | ngậm ngậm miệng
hơgâr | sơgâr sơgốtr | pơ nâng | trống cái trống tiếng trông
hơgơn | kogơn | hơkơn | gỡi đầu
hơgơp | lowah | bơlôh | lỗ nhỏ khe đá
hơguăt | hơguăt
hơguot hoh | bò cại con bỏ cạp trồng | hoh | hoh | hoh trống
hoi | hoi
uưh hơi kơ đei
không
hoi kơ đei | hoi kơ đei | không có
hơiã | hơiă | hơiă | dễ chương
hơioh | hơioh | oh ngc | em bé
hơioch | hơioh | hơioh | trẻ nhỏ trẻ em
hơkă | hokăt | Jak | gùi nhỏ
hơkăn | tơiong | tơiong | Vợ
hơkăt lẽ | hokăt lẽ | hokăt lẽ | gùi nhỏ
hơkañ đẽš | hơkañ đềš | hơkañ đềš | cá tri thôi
hơkap | hokap | hơkap | bẫy
hơkar | hơkar | hơkar | da
hokš | hơkš | hơkš | gầy ốm
hơkš hơkong | hokš hơkong | hơkš hơkong | gẩy yếu | 
59