hă] | hãi | hãi | chán chán nản
hăm | hăm | hăm | với
kăn hap | kăn hap | kăn hơ | vợ nó
hăp hap | hăp hap | hăp hâp | em nóianh ta ông ấy
hăp đei | hăp đei | hăp đei | anh có
hăi khan | hấi khan | hăi khan | ông ây nói
hăt | hắt | hãt | bận bận rộn
hắt | hặt | hăt | chát
hăt hứt | hăthot | hắt hot | vội vàng
hâk | hâk | hưề | mừng mửng rỡ cảm động
hâk | hâk | hư | vui vui mừng
hâk lơ | hâk lơ | hơk lơ | cảm động nhiều
hâm | hăm | hơm | với vẻi mọi người
hâm kơtâng | hâm kơtâng | hâm kơtâng | có nghe không
han hang
han kông krang
han | sắc byn
hang tông hâng krang hấp khan hấp khan | kông dơng hâi khan
núi
hâng hấi khan | krang dơng hấp khan hâi khan | đôi ông nói | hấp khan hấp khan hâi khan | hấi khan | hâp khan ông nói
hấp mil | koñt hil | đuk | tứn giận
hâp wä | hâp wä | hâp wä | ni muôn
hât | hât | hât | thđốc lá
hšš | rơhšš | bữk | mục ngt
hiâk jâi | jâi | mi | khó khăn kẹt
hiếk | nă | dếk | cưởi
ch | hi | h1 | giận tứn giận
hiỡ | hiỡ | hiỡ | chậm chậm chạp
hiờk | pơngât | mơkiong | lo lắng
hiơhiâr | hơtăng | hơtếng | mỏng tỏng dảy
hiôk | hiôk | hiôk | hay saớng vui | 
54 :