tơ ala | tơ ala | tơ ala | dưới dưới
tsangla | tsangla | tsangla | chủ chủ nhà
tơ angualh | tơ angualh | tơ'ngah | bên ngoài
tơbăt | tơbất | tơbặt | báo hiệu
tơblah | tơblah | tơblah | chiếngtranh
tơblah | tơblah | tơblah | chiêngđâu
tơblang | tơblang | tơblang
giải thích dịch giảng đản bầy nhóm | tơbôi | tơbôi | tơpu]
tơbũk | tobữk | tơbũk | bạc trắng
tơdä | tơdă | tơdă | bản bạc
tơdăm | tơdăm | tơdăm | thani niên
tơdah | todah | tơdah | như ngu
tơdah . | todah | tơdah | mơn mởn
tođah gð | tơmo hu | tơmo hu | ông táo
todnhỏtođê tơdra tơdrang
tơdah | yvah tăng
nêu mà caở đợi
tođô gô gô chờ đợi tơdra todra todra dấu dấu{thanh
gô | gô
tơdrantơdrang lẽ
todra | dấu dấu{thanh
tơdrang tơdrang lẽ | tơpu lẽ | tổ tổichim nhỏ
tơdrõu | todrðu | tơdrốu | số sáu
t{drong | t{drong | t{drong | công việc câu chuyện oân đê
tơdrong jang | 'tơdrong Jjang | tơdrong jang | công tác công việc
tơdrong juăt | tơdrong luặt | tơdrong juăt | phong tục truyền thống
| todùa | | todùa | | todũa | nội bộ
'tơgữm | | tơgăÖm | | tơgũm | giúp đỡ hỗ trợ
| tgzuêng | tơguêng | tơguêng | | xöe (xöe 1a)
ltôh | | tôn | | tôn kơ gð | đánh gõ
|tohek | | tơhak | | tơhek | rách to rách
tơhlơ alơp | tơhlơ alơp | tơhlơ alơp | cảnh non cá non | 
109