pỗ | pỗ | pỗ | thông gia
pỗ hấp | pỗ hăp | pô hắp | ông bả thông gia hủa họ
pơ ñð | pơ'ñö | pơñð | tiếp đãi
pơ ñð | pơ ñð | pơñõ | dảnh{riêng
pơ angm | pơ angm | pơ angm | siêng năng chăm chỉ
pơangâng | pơangâng | pơ ngng | ngóng nghe
pođĩ c | pođĩ | pođi | hết hứt thấy
poơđăn tu | pơđăm jJĩït | pơđăm jĩt | 50 (số)
pơđãp | pođặp | Jơnep | gọn gàng ngăn nắp
pođấp | pođặp | pơđặp | bản bạc
podăr | pơdặr | pơdăr | xung{quanh
pơdah | pơdah | pơdah | soi sơng trình chiếu trìnn diện
pơdâi | pơdâi{pơđei | pơdâi{pơdơh | nghi ngơi
podâng jrăng pơdei pơdjong pođốu
pơdâng jrăng | tơ iung jrăng
dựng cột nghỉ
pơdei pơdei pơdei nghỉ pơdjong pơdjong pơ djong tô điểm pơđốu pơđấp hnùk trỏ chuyện
pơdel | pơdei
p̆djong
pơ djnng hnùk | tô điểm trỏ chuyện | pođốu pơđấi hnùk | pơđấp | hnừk trỏ chuyện
pơđông | pơđông | pơđông | làm cho nổi lên
pơdrăn | pơdrăn | pơdrăn | mồi thức ăn cho cá chim
pơdrăn | pơdrăn | pơdră | tha hồ
pơdronsa | pơdronsa | pơdronsa | buôn bán
pơdrðng | | podrðng/ podrong | p{drõng | ghàu có
pơdrũt | | pơdut | "pơdut | bắt baộc
| pơdă | | pơdð | Lpodũ | luân }huyển đồ đạc
| poga | | DƠgaT | pơđ at | rảo hàng rào
| pơgah | | pơgah | | tơgah | bên phía
pơgang | pơgang | pơgang | | thuốc | 
92