šlhẽi | šlhi | ẽhh ši | băt chì
šnh iing | ẽnh jag | ẽnh lìng | viết{thảnh
nh mă tr | šnh mă tr | šènh mă trõ | viết chc đúng
ẽmg ẽmng | šmg šêng | ing êng | chiêng cồng chiêng
šơ găm | mă kăm | šơ găm | cảng{thích
šơ kơi | šơ kơi | šơ kơi | thác
šðng | asong | song | cho
“ống | cống | “ống | nhưng mả
šðng | Gõng | šðng | xong sau đó
Xươẽèä | Cošäã | šošäã | tìm kaếm
šơšoh | šošoh | šơšoh | băm thịt đánh máy
šô đĩ | šð đĩ | šô đĩ | cệt hit
šơgăm | šơgăm | hơlom | chăm chỉ
hơlom | hơlom | hăng hái
Cogăn | šơgăn | vách ngăn
pông{dơhnă | bðk/ dơhnä | cuốc đuốc đất
šoh hiang | šoh hlang | khai{hoang
šoh Jang šoh mă kơtang | šoh Jang ẽoh mã kơtang | lao đang cuốc hăng say | šoh mă kơtang | ẽoh mã kơtang | ẽoh ma kơtang cuốc hăng say
šoi kặt | šoi kất | thu{hoạch
tơkơi | tơkơi | thác tháy nước
šơnăt | šơnăt | chôi
šơnẽng | ẽơnẽšng | tưởng vách nhà
šong | šong | nhưng mả
šop | šop | rình mèo rình chuột
šof | ðor | đảo đảo{mương
ẽor hơbong | ẽor hơbong | đảo{mương
šră | ẽră | sáng chói
šrâu | ẽrâu | khoai khoai môn
ẽnhh | ẽrnh | | mách | 
43