hơmrš đuụm | pơhăng đum | amrš đum | ớt chin
hơmršš | hơmršš | sơmcš | con môỗi
hơmũk | hơmũðk | hơmũk | tải sản
hon | hon | hon | mọc
hơnăm | hơnăm | hơnăm | tuôi năm
hơnăn | mặt | mặt | tên
hơnâng | hơnâng | tơmâng | he lắng ng nghe
hơnâng hơnê | hơnâng tốk bðk/ nễ
hơnâng | đều đều nhau
hơnê tốk bỡk nễ | tk bðk | giữa chính giữa
hơnglung | hơmông | hơmông | buông chuối
hơnguang | hơnguang | hơnguang | săn byn
hơnguang sa | hơnguang sa | hơnguang sa | kiếm sống đi săn bắt
hơaih đê | hơnnh | hơnih | nơi noi chỗ
hơnih hoh | hơnnh hoh | hơnth}hoh | vắng vẻ nơi vắng chỗ trông
hơnong | kơpð
hơnong bặt
rơm
hơnoơr | Tu | thức dậy
hơnùk | hơnùk
hơdal hơnũk
bình tĩnh
hơnùk | hơnÙk | hạnh phúc
hơnðk hơnua | rơnðk rơnua | rơnùk}rơnua | bình yên
hơnua | hơnua | hơnua | hỏa bình
hơnul | sơmañ | hmañ | đùa đềa giỡn
hơpăk | TƠ | TƠ | rựa cái rựa
hơpïñ | apiñ | piñ | xin xâm cho
hơpiñ | hơpiã | hopiñ | hỏi
hơpiãñ Jet | hơpiñ jet | hơpïñ jet | xin hỏi xio thưa
hơpo | hơpo | hơpo | mơ chiêm bao giắc mơ
hopơi | hơpơi | hơpơi | ao ước hơ ước
hơpơi | hơpơi | hơpơi | mởi mong ước
hơpôm | hơpôm | hơpôm | nguyên vẹn | 
61