pơjôk | pơjôk | pơjôk | trao đổi
DƠjr€ | pƠJre | dang ăi | đồng đều đều nhau
pơ]uät | pơ]uät | pơjuăt | luyện tập
pơkă R | pơkă | pơkă | báo hiệu
pơkai | mơkai | mơkai | dưa dưa hấu
pơkao đâng | tang ri ri ngiã | tang til rơ ngiă | chùm toa óng ánh
p{klaih
tơ'nglaih pơkoih
tơ'nơi
khấn bái ngứa ngáy
pơkoih{pơkôi
pơkoih pơkoih ngứa ngáy | pơkoih
ôr | thôr | gò đất
pơkong | ðng mai | tơoẽi | đám cưới
pơkro | pơkroh | pơkroh | phoi khô
pơlmh | pơtnh | pơtnh | giúp đồi công
pơla | pơla | pơla | nhân vân
pơlam | pơlam | pơnam | cân củ
pole | pơle | pole | cây le
polšu pơolei pơlei
pơlu | polšu
chim thảo mảo làng xóm thôn | pơlei pơlei pơlei làng xói thôn
pơlei pơlei iñ
pơlei
polei |polei iñ | pơlei tñ | làng tm
pơlei ñôn | pơlei ñôn | pơlei ñôn | quê hương chúng tôi
pơlei âu | pơlei âu | polel âu | làng này
pơlei ei | pơlei ei | pơlel ei | làng nọ
pơlel tế | pơlei lẽ | pơlei 1š | làng nhỏ
pơlei pơla | pơlel pơla | pơlei pơla | quêchương
pơlei sitơr | pơlei sitor | pơlei sơtor | làng sơtor
pơlôš | pơlôš | polôš | giết
pơlong | pơthi | pothi | thi thì cử
pơlung | pơlung | pơlung | động viên
pơlung oh | pơlung oh | pơring oh | ruem | 
94