tp tep hlâk | tep tơp hlâk
ngủ
tephikk | tep hlâk tep hlâk | ngi quên
teppok | tep pơừ | tep pơok | ngủ say
tep tơn | ñep “ñer | ñep “ñer | lim đềm buồn ngủ
thĩ sah | thĩ sah | thĩ sah | thị xã
thâi | thơi | thei | thầy
thâi kô | thei kô | thơi kô | thầy cô
than : | than | thar | nhto tới
than along | tơblanalong | tơblanalong | cảnh đây
thoi | thoi | thoi | như giống như hình như như vậy
thoi anao | thoi anao | thoi anao | như mới
thoi âu | thoi âu | thoi âu | như thế này
thoi hnam thoi lẽ | thoi hnam ˆ thoi lš
thoi hnam
như nhà như chư là | thoi lẽ {hơilẽ | thoi lš thoi lẽ như chư là | thoi lẽ
thoilu | thoi lu | thoilu | như{những
thoi noh | thoi ngh | thoi noh | vì vậy vì thế
thoi sem | thoi sem | thoi sem | như chn chim
thoi vơ | thoi vơ | thoi vơ | như thế nào tỏi sao
thôn trưng | thôn trưng | thôn trưng | thôn trưởng
thong | thong | ! šơ điêng | con sôôi
thong | | thong | | thong | khi suối
thông | thông - | | šä ngôi | quanh quần đi chơi
thông đẽš | ngôi đề | hơlah | lười{biếng
thông tơ đak | thông tơ đak | thông tơ đak | tảnh nước
thôr | thôr | tơ'măn | giảnh dụm
thũng{thong | šodrăng | šơdrũng | thung lũng
q | ũ | t | tay
tieu | tieu | tieu | đeo
th jat | tih jat | trh âlâng | to đẹp | 
106