bôkloa | năm hơyô | hơngonng | đi săn
bôi bôi bãi | bôi bôi bã | bôl bôi bãi | bạn bạn bẻ
bôi juất bơlăm
bôi Juăt bơlăm bơlð
bôi juăt bơlăm | bạn thân bàn tán
bơlăm bơlăm bơlð bơlð | bơlăm bơlăm bơlð grăn
bơlăm bàn tán | bản thn
grăn | sốt | bơlð
bơolð | bơlõ | bơlð | sốt đồu sốt
bơlôh | bơlôh | bơlôh | lỗ cái lỗ thay phiên
bon kang bơnal
bon kang | bon kang
bóng vửng đùa ca | bơnai | bơnai
bơnat | tmơnat | mơnat | tôi thi nghiệp
bơnat jat | monat dêh | bơnat dêh | tôi lâm iệp
bơnê | bơnê | bơnê | cam ơn xeez xen ngợi
bơng iak | bơng iak | bơng iak | bê nưec
bơngai
bơngal | bơngai | ngƯỜI (gõ Zgười]
bơngai dơnuh | người nghe
bơngai dơnuh bơngal po{drong
bơngai dơnuh
bơngai pơdrong bơngal{rơgei
bơngai p{drong
người giả cc bu nhân tải
bơngal rơgel{bơnôh | bơngai rơgei bơngai rơgei nhãn tải bơnôh bơnôh tâm hỗn
bơngai rơ ei
| bơnôh | tâmhóp ii | jbơnôh
bơnhh | lâm jaĩơhngâm | lâm jơhngâm | trong lỏng
bơnôh | bơnôh
ibơnôh | tâm lang
măng yũng | nguyệt thực | | bơnuši khei | măng yăng
bơtho | ibơtho | |botho | ldạy đtvhọcc
bơsat -_ | bơsat
| bơsat | mô, ma
bra | vải thm vai | |bra | bra
brâk | brâk | brâk | xúc động
hrang brai | brang brai | brang brai | sáng xủa
brâm brâp | brâm brâp | brâm brâp | bầm đan
bre | bar anu | bar 'nu | hai người
bre c
bre | bre | hai người hai đôi tượng
suh | họ | bre | sư | 
38