pơsat | pơsat | posat | nhà mô
pơsêh | moơsch | mosch | áo thuật phi phép
posùn | kang kưt | kũ | cái chòi trại
pơsðt | pơsùt | pơsũt | đặt ra
posuât posuät | posuât posuäăt | pơsuât posuăt | nhộn nhịp qua lại
posuh | pơsuh | pơsuh | múa khêm
poyăn poyan ššt
poyăn poyan | poyăn
mùa mảng mùa xuân mùa hè | poyangšät poyan šặt poyan šặt mùa xuân poyan oi pơyan puih poyan pulh mùa hè
pơyan Èšặt | poyangcặt
poyangoi | pơyan puih | poyangpulh
pơyan ami | doyan ami | poyangami | mùa mưa
pơyan âu | pơyan âu | pơyan âu | mùa ngy
pơyan nai | pơyan nai | pơyan nai | mùa khác
poyangruth | dơyan ruih | pơyan ruih | mùa thu
pơyua | pơyua | pơyua | bổ ích
poyulềprăt năr
pơyul
pơyul prất năr | sản nhà cả ngày suốt ngày | prăt năr prăt năr prất năr | prăt năr | prất năr cả ngày suốt ngày
pran aran alâng
pran | pran | khỏe khỏe mạnh
dran alâng | dran alâng | khỏe đẹp
Drao | prao | Prao | con rông
prch | prch | prch | phẩy đập lúa
prit | pH | Dit | chuôi
prit tơnư wơng | prit aha | pit bia | chuốichương
pro | krống | pro | quả cả
prok | prok | prok | cên sóc
pu | puh | puh | sập bay
pũ | pũ | pũ | cống gùi nước
pũn ai | pũn ai | mân mãi | may mắn
pùng lũng | pũng lũng | pũng lũng | cái hồ cái hầm thung lũng | 
97