klang kok | klang kok | klang kok | con cỏ
kiẽñ | | klẽñ | | klếñ | | trốn m
| kiếng | kliêng | kliêng | ! trán
kl̆p amê | kl̆p amê | kl̆p amê | dính bắn
klaih noh | klaih noh | klaih noh | sau đó
klo | ko | | klo | chồng ngưởi chồng
klo hấp | klo hấp | klo hấp | chồng nó
klo hơkăn | klo hơkăn | klo hơkăn
vợ chông muộn muộn mảng | khu | klui | klui
kơbang | kơbang | kơbang | bảng đen
| kơñang | kơ ñang | mơnang | hình như
| koñang | kơñang | kơñang | óng ánh
kơ ang sô | kơ anä sô | kơ anä sŠ | vui mừng
kơ ang | kơ ang | kơ ang | mầu suc
kơ ba | kơ ba | kơ ba | cho nhau
kơ đe | kơ đe | kơ đe | ngưởi ta người khác
kođch | kơđch
kođch kơ đei
ngắn ngắn dài có có không tự mình bản thân
kơđei{kơdih
kơđei
kơ đei có có không kơdih tự mình bản thân
kodihekodih kodih tự mình bản thân kơ đon kơđon kơ đon ngẫm nghĩ
kơdnh | lkaơch
kơđon | kơđon | kơ đon | ngẫm nghĩ
kơhơdruh | adruh | adruh | con gái
kơ kon kơm | kơ kon kơtu | kơ kon kơm | chỉ về người làng{hoang
kơ kon{pơlei | kơ kon{pơlei | kơ kon{pơlei | với dân làng
kơ krê | kơ krê | kơ krê | nguy hiểm
kơ lu pơkao | kơ lu pơkao | kơ lu pơkao | các loải hoa
kơ măng | kơ măng | kơ măng | tối
kơ mặng | kơ măng | kơ măng | buổi }ối
kơ mẽ bă | kơ mẽ bă | kơ mẽ bă | bô mẹ
kn mống | kơ mðng | hmðng | trắng tinh trắng xóa
kơ năr | kơ năr | kơ năr | ban ngày | 
71