<
hloi . | hloi | hloi | luôn ngag liền
hiôi | hlôi | hiôi | qua vưăt qua
athei | athei | athel | phải aần phải
hiôi hlai | hlôi hlal | hlôi hlal | tràn trễ lăm cộm
hiôm | thu | thuôi | thổi
hiêm . | hiôm | hiôm | thổi thoi lửa
hlut | lu | lu | tin mồc lửa
hmã | hmă | hmă | thương bình chương
hmẽšñ | kuăng | mă rẽñ | nhanh nhanh nhẹn
hmẽñ | hobšš | kuăng | nhanh nhẹn
hmẽñ truh | hmẽñ truh | hmẽñ truh | đã đến
hmẽñ wð | hmẽñ wð | kuăng wø | nhanh lớn
hrmôš c | hmôẽ | hmuôẽ | con khên
hmrð | hơmrð | hơmrð | có thể
hnam | hbnam | hnam | nhà cái nhả
hnam šam . hbnam bu
hnam šam | hnam šam | nhả cha
hnam bu | hnam bu | nhà ai
hnam dơnð | hnâm đơn | hnam nơng | gia đổnh
hnam găẽš | hnam găẽ | hnam găẽ | nhà xây
hnam gia | hnam gia | hnam gia | nhà{tranh
hnam hơmãi | hnam hơmãi | hnam hơmãt | nhà miy
| hnam kơ añữ | | hnam kơ añữ | | hnam kơ añữ | nhà ting nhà sản
hnam rông | hnam rông | jhnam rông | nhà ring
hjam so | hjam so | hjam so | nhả cũ
ho | hơ | lhơ | nhé nhé nha
hobăng | hơbăng | hơbăng | thính giác
h}oblih | tơplnh | ltơpih | thay đồi
|hơkăn | | hơkăn | | hơkăn | vợ
'Hơ Ơi | iho ơi | 'HơƠi | |Hơ Ơi
ihơtalh | ! atalh | (hlð | xa xaigần | 
56
M ũ