hơkšñ | sơkềñ/ hơkañ | sơkẽñ | cá trê
hơkðm | akðm/ hơkăm | akðm | dồn tập trung
hơkðm lš | hơkðm lẽ | hơkðm lš | tập trung để
hơkok
šơkok hơi bặi
sơkok
cái chiều thoăn thoắt | hái bãi | hoi bai bơi bãi thoăn thoắt | hái bãi
hơla | hơla | hơla | ở đưới
hơlă | hơlăã | hơlã | giáo mác
hơlah | alah | hơlah | lưởi{biếng
hơlâk hơlšš | hơlâk hơlšš
lâk
trải trải chiếu phía đông | hơlšš |hơlếš | hơlšš |hơlšš | phía đông | hơlšš
hơlšñ | plaš/ podăr | plaš | lừa dai
hơleh | Cõng | kch | sau đó
hơÍeh | šðng | hơleh | tỉa cây
hơii | hơi | hủ | sợ sợ sệt
hơlieng | kơdrăk | kodrăk | lõi cát lõi
hơlởk | hơlỡk | hơlỡk | lại tâở lại
hơlðng hơmăn | hơlðng kođong
hơlõng
họng cô họng dảnh dụm | hơmăngkođong | kođong kođong dânh dụm | kođong
hơmâ] | hơmâl | hơmâi | mây
hơmau | tơm | tam | kịp kai thời
hơmẽếš | sơmšš | sơmẽšš | muỗi ton muỗi
hơmẽng | h{mẽềng | hơmšng | hv vọig
hơmet | hơmet | hơmet | sửa chữa chuân bị ăp xêp
hơmð | hơmð | hơmð | có thê
hơmoh | kơdră | kơdră | đầu lòng con đầu lòng
hơmoh | hơmoh | hơmoh | tặng auả
hơmră | hơmră | hơmră | chim tông
hơmraš | hơmraš | hơmraš | la hét
hơnmưš | hơmrš | hơmrš | ớt quả ớt | 
60