ðu | âu | nảy đây
âu Jĩ | âu ]jï | đây lả
bĩ | ară | không đúng không còn không đi
bĩ/ưh | ưh i | không không sao
bĩ bắn | ưh kơ bôh ưh kơ bôh | không thấy
bì am m
ưh am m bĩ đei
không quý
|bï đei |bĩ đei . | bĩ đei | không có
bĩ eng | th kơtbu | không ai
bĩ găn | bĩ găn | không biết
bĩ găn | ưh kơ găn | chưa thắc chắn
ibigơh | hïĩ gơgh
không được
bĩ hơñð | | bĩ hơñð | ti chối
đon phxắút | đon pơxặùt
lưu luyến không còn | bĩ kãi | bĩ kã]
bĩ kẽ | bĩ kẽ | không nổi
bĩ lap | bĩlap | không mêt
ưh kơbău{bĩ lẽ | ưh kơbăt/ bĩ lš
không biết không tin | ựưh kơ lui | ưh kơ lui
bừ bơdơh | bĩbodơh | không nghỉ
bĩ tũk | bĩ tữk
không vứt không muốn dẫn đắt
bĩ wä | bĩ wă
nhăk | ba
băt | bặt
biết nhớ
bặt hiôh | hăt hiôh
nhận thức
bahnar | bahnar | bahnar dân tộc bahnar
bơn bân | bơn bân
bân | hân
mănh ta
bân bah | bân bah
ta thấy mình thầy | 
| 5