plei along | plei along | plei along | trái jây
plei jrang | plei jrang | plei jrang | quả chôm chôm
pleijai | plei jri | pleijai | quả đa
plei lơ | jai git | siâm gẽ | trqu quả
plei lợ | plellơ | phe lơ | quả nhiêu
pleisu | plei su | pleisu | quả sồ su
phm | phim | phm | ngòi bút
ploi | plơi
ploi plũn
vượt tua con nòng nọc thân thể bản thân | plăn ro | plũn hơkâu | phũn aon nòng nọc hơkâu thân thể bản thân | po hơnâu | hơkân hơkâu thân thể bản thân | hơkâu
po | po | po | mơ giac mơ
pơšrang | pơošrang | pơšrang | chiều chiến sáng
pơñôm | pơñôm | pơñôm | nói quá không đúng si thật
pơ alâng | pơ alâng | pơ alâng | gọn gàng
p{kleng | p{kleng | p{kleng | vang tên
pơ sơnluh
sơmruh posố pơ-ư pðk | sơmrua pơtơm pơ pl
câ̆ dang
potơm kơ pốk
posố pơtơm | rủ rủirê
pơ-ư | pơ-ư
pơ-ư | pơ-ư
khoe ca ngợi lật lật sách vở | pỡk |pðk | pðk | plök | pl lật lật sách vở
pơšah | pơšah | pơẽah | vỡ nảy mâm
pơẽšu poššš | pơššu poššš | pơššu poššš | chỉ tiếng hót của chảo mảo
pơšeh | pơšch | pơšch | sáng tạo chn biến
pơšch | pơšch | pơšch | nởngả nở
pơšoh | pơšoh | pơšoh | cuốc đày cuốc
pơèẽơt | pơšẽơt | pošơt | vui vui vẻ
pơšut | pošut | pơšut | thúc dục
pơñal | pơñal | pơñal | chói tọi sáng chói
pơñan | pơñan | pơñan | chén tái chén
pơñen | pơñcn | pơolñen | nhìn chằm chăm
poñtk | poñùk | poñữk | súi giục | 
9%