bôñ/ hiôk | bôñ/ buôñ | đễ, dễ dảng
bôk | bôk/ năm | đi
bôh | bôh | thầy (nhìn thầy)
bôh prit | bôh pit | gùi chuối
bơi lơi | bơi lơi | cây bởi lởi
bok | bok | ông (Ông ngoai/nôi)
Bok Hô | Mã Hô | Bác Hồ
bơm | tr | trúng
pông tch | pông teh | đảo đất
brâk | ơh | cảm xúc. xúc đông
brê brăng | brê brũng | đỏ hỏng
brưễ | brưế | nhô (mặt trời nhô lên)
bruhh brăm | bruih brăm | bui băm
bũ | bũ | lắp. vùi. chôn
hmašẽ, anêm | amêm | thương (thương vêu)
buh | buh | nướng (nướng thit. cá)
buh sa | buh sa | nướng ăn
bum | bum | khoai, mì (củ mỉ, củ
khoai)
Èởïng šêng | ðïng šêng | cái chiêng
ễă | li] | tìm. kiếm
Că bâu | šăš bâu | tìm mùi. tìm hơi
Că gõ | Că gÕ | tìm cái nồi
Că] hle | | Cšăl hle | thời đai mới
hon | đah | nhú, nhô (cây vửa nhú lên,
nhô lên)
Èšai(kơšök) | Cai | chai (cái chai)
šẽam | ẽam | sân
ễam kơtao | ẽam kơtao | bãi mía
Èšam să | | šam să | quảng trưởng
