Ñ. | bơ | bơ | cá lóc loại nhỏ
Ma. | pơm/ jang | DƠHƯ jang | làm
Mi | bỡ | bỡ | đắp (đắp bở)
- hở brai | bở brai | bỡ brai | dệt vải
- bó jang | bỡ jang | bỡ jang | lao động
-„ % khôm | bỡ khôõm | bỡ khốm | cố gắng
Sở kơlung | bở sơlung | bỡ sơlung | đảo hồ
^% m | bỡ mir | bỡ mỉ | làm rẫy
hở na | bỡna | bỡng | làm ruộng
Sở. gắn | bỡ, găn | bở, găn | ngăn (ngăn dòng nước)
5ởJjang | bỡjang | bởjang | lao động. sản xuất
56k | bðk | bðk | đục, tạc. khoét
bồi | bôi | bồi | hũ, vai (cái hũ)
bởjang | bởJang | bỡjang | làm việc
bôk | năm | năm | đi
bök găn | bôk găn | bỗk găn | đi qua
bôk Jang | bốk jang | năm jang | đilảm
bök tơ kông | bôk tơ kông | bốk tơ kông | đi lên rửng. vào mng
bơang | bơang | bơang | khoe khoang
bơbäh | bơbăh | bơbšăh | hướng bắc
bơbrơng | bơbrơng | bơbrơng | nằm dải
bơbùÙk | bơbÙũk | bơbũk | xúc bùn
bơbũng | bơbũng | bơbũng | mái, mái nhả
bơbũng | šơkup | pơdah | mái (mái nhả)
|bơbuh | bơbuh | bơbuh | mô hôi
bolh | bơih | bơinh | Hi
TOI
bonh | ôh | bơlh | ˆ. ki
đâu, rồi
bơm | bơih | bơinh | À: B
rồi (xong rồi)
bơnh pô | bơnh pô |  | rồi bạn
bôk | năm | vak | đi (bước đi)
