đak mi | đak mũ . | đak mi | nước mưa
đak ngom | đak ngom | đak ngom | nước sương
đak ra . | đak ră | đak ră | nứt nẻ
đak ro | đak ro | đak ro | nước chảy
c̆ơdrâm | sơdrâm | cái giếng | đak sơlŭng
đaktih | đak teh | nước lớn | đaktih
rơlat | hlu | nước dâng
đak tơ đak toh | đak toh | đak toh | sửa
đah | đah
đah | mọc
hơleh đâng
xong thoải thành) | đang
đang đâng/ vâng
đâng
đâng/ vâng  đâng | từ (tơ nay trở đi), của, những
‘lâng ataih | đâng ataih | tơ xa . | đâng ataih
đang bơih | đang bơih | đang bơih | đã xong. .: am.
đâng bri | đâng bri | tơ rừng... |  đâng bri
đâng đak |  đâng đak | đâng đak |  vi nước
đâng em | đâng noh |  đâng noh | tơ đó. tơ đấy
đâng là | đâng là |  đâng là | ị  con nhỏ. tơ như
đâng ngữ | đâng ngữ . | đâng nge | tơ bé
đâng rồng | đâng rồng | đâng rồng | sau (đi sau). sau nảy
đâng sa | đâng sa | đâng sa | tơ xưa
đâng tu | đâng tu | đâu nguồn | đâng tu
đao | đao | đao | gươm (cái gươm)
đe m | đe | họ. người ta | đe
lahnur | jơmur | họ trỉa (tih lúa, bắp) | đe ơmoi
đe tơmag | đe ‘ñŏng - | đe ơtaing | các anh
đe ang | đe ang. | đe ang | họ khen. họ ca ngợi
đe Blan | đe Blan | đe Blan | bạn Blan
đe bri | đe bri | đe bri | các bạn | 
48