kông ñân | kông ñân | kông ñân | công nhân
kông Ablu | kông Ablu | kông Ablu | núi Ablu
kông ană | kông ană | kông hyek | núi cười
kông là | kông là | kông là | núi nhỏ
kông kơ iung | kông kơ iung | kông kơ jung | núi cao
kông krang | kông krang | kông krang | núi đôi
kông ơi | kông ơi | kông ơi | núi ơi
kông pah | kông pah | kông pah | núi cười, núi thân
kông yă Nâm | kông yă Nâm | kông yă Nâm | núi bĭ Nâm
kơnguang.... | kơnguang.... | kơnguang.... | năm luôn lại
kơnong | kơnong | hơnong | Tơm
kơnơp | kơnơp | kơnơp | núp (ấn)
kơpal | kơpal | kơpal | trên, phía trên, bên trên
kơpang ti | kơpang tơ | tơpang tơ | bản tay
kơplah | kơplah
kơplah kơplah đi
lúc, khi
kơplah đi | kơplah đi | lúc nảy, lúc đó
kơpô | kơpô
kơpô khor
con trâu
kor | khor | chải, cho
kơsơ̆ | kơsơ̆ | kơsơ̆ | buổi chiếu
kơsu | hơthu | hơthu | đắp (đắp mền)
kơtă | kơtă | kơtă | tại chỗ
kơtă ei | kơtă ei | kơtă đi | lúc ấy
kơtăn | kơtăn | kơtăn | quả còn non
kơtăp | kơtăp | kơtăp | quả trứng
kơtah | kơtah | kơtah | rơi, nhảy (nhảy xuống)
kơtah | jur | jur | xuống, nhảy xuống
kơtam | kơtơm | kơtơm | kịp, kịp thoi
kơtân | kơ”dân | kơting | bậc thềm
kơtâng | kơtâng | kơtâng | nghe (tai nghe), nghe tiếng | 
75