gơh | gơh | gơh | được (sẽ, biết)
gơh băt | gơh băt | gơh băt | nhân cách
gơh băt | gơh wao | gơh lễ | hiểu biết
gơh gai | gơh gai | lặp gal | vừa, vừa vặn
gơh rơgei | gơh rơgei | gơh rơgei | giỏi dang
gơh wih | gơh trống | gơh brŏk | mới về
gơh yua | gơh yua | gơh vua | có ích
goi goi gâng | kơmrâng goi gâng
kơñ mông | ngọn, lâm
goi gâng  goi gâng | goi gâng | ngọn cây nêu
goi hla along | goi hla along | gọi hla along | ngọn cây
gườiT | gaơhri | alongjri | cây đa
gơlŭng | gơngŏkg | gotơng | lũ lụt
gơlŭng | gơlŭng | gotơng | tấn công
pơnil | pơnil | pơnil | nhận ra
gơng ‘nao | kơtuaonao | bor ‘nao | cái câu mới
gơning | gơning | gơning | dâng (tựa vào)
gram | gram | gram | đon (dọn rẫy)
grâm | grâm | grâm | sem
grang | rang rah | lăn | ra xúc cá (loại nhỏ)
grê | grơ̆ | grê | nghiêng, xiêu
grĕñ | grĕñ | grĕñ | nhe răng (gầm gô)
ngàỡ | grơ̆ | Bư̆t | con chim kon kon
grơ̆ akhan | grơ̆ akhan | grơ̆ akhan | kon kon nói
groi | groi | groi | đồi, đổi núi, đất trên cao
găm | gŭm | gŭm | giúp (giúp đỡ)
gŭm bĭ | găm bĭ | gŭm bĭ | giúp cha
gŭm mă | gŭm mă | gŭm mă | giúp mẹ
guăng | alâng | liền | đẹp
hai | hai | hai | khát (khát nước)
hai | hai | kơlok | khát nước | 
53