kơtao | kơtao | kơtao | mía
kơthơ | kơthơ | kơthơ | lá thư
kơang | kơang | kơting | xương
kơtoh | kơtoh | kơtoh | nhỏ giọt
kơtơm  | kơtơm | kơtơm | ngực
kơtol | hơtol | hơtol | treo
kơtrŏ | kơtrŏ | tr | đúng (đúng ><sai)
Tơm - kơtuei
Tơm | Tơm | làng hoang
kơthiên | kơ tuôi | cục (cục đất)
kơtuh | kơtuh | kơtuh | cái tủ, vỗ, phủi
kơtul | kơnong | kơtul | lạc hậu, ngu
kơtuơ | gơng | bor | cái câu
kơđong | kơmrâng | kơwơih | vẫy gọi
kơsơ̆ | kơsăi | kơsơ̆ | chiều (buổi chiều)
kră krŭt | kră krong | kră krong | giả côi
kră
kră kră pơlei | kră kră pơlei
giả (giả cả)
kră pơlei | kră pơlei  kră pơlei | giả làng
krâc̆ krâc̆ kram | krâc̆ krâc̆ kram
krâc̆ krâc̆ | cả đồng
kram  kram | kram | tre (cây tre)
krang | krang | krang | dốc (đường đốt)
krang | krang | rơgei | dốc (đốt đào)
krao | krao | krao | gọi (kêu gọi)
krao lok | krao lok | krao lok | kêu lấy, gọi lấy
krê | krê | krê | nguy hiểm
krê kiơ | krê kiơ | và kiơ | cái gì
kro | kro |  kroh |  khô (cây khô)
 krong | krong |  krong |  thức khuya
 krôm |  krôm |  krum | gầm (bản, ...)
 krong |  krong |  krong |  sông, dòng sông (sông Ba)
 krông |  krông |  kông | núi | 
76