reh | rah | rah | đánh (đánh đon)
jet | jet | jet | cưa (cưa gỗ)
rih rim | ring rông | rih rôm | gầm như
rim | rim | rim | các, mỗi (mỗi, mọi người), suốt, khắp
rim | rim | rim | suốt, cả
Tơm anu | Tơm anu | rim anu | mỗi người
rim kơ na | Tơm kơ na | rim kơ na
khắp cánh đồng mọi ngày, suốt ngày | rim năn | Tơm năr | Tơm năr
rim pơlei | Tơm pơlei | rim pơlei | các làng
rim rong | Tơm rong | Tơm rong | mãi mãi
rim sơnăm | Tơm sơnăm | rim sơnăm | mỗi năm
ring ding | ring ding | ring ding | âm âm
TV | yol/ yol/ ior | yol 101 iok | cháu/nước chảy
rơ hơdah
rơ hơdah to mật lơ mân | rơ hơdah ro mât lơ muăn
sáng (ánh sáng)
TV mât rơ muăn
to mật  ro mât
chảy vào mềm (mềm mại) | rơ muăn  lơ mân | lơ mân  lơ muăn | lơ muăn  mềm (mềm mại)
tơ năm | tơhngâm | tơhyŭm | chùm (chùm cây)
TV | TV | TV | đẹp, oai phong
rõ alâng | TV alâng | ra alâng | đẹp đẽ
rõ dêh | TV jat | ra dêh | oai lắm
ra leh | ra leh | thoi là | như là...
rongt | rŏjat | Tiếnt | hùng vĩ
rĕk năng | rĕk năng | rĕk năng | ôn tập
sơng | rừng | trống | phía sau
rơbăn | ƀrơdăn | rơbăn | hàng vạn
rơbot | hơbĕn | rơbăt | biết nữa...
rơbâk | rơbâk | rơbâk | cái rựa | 
99