bơ | bơ | cá lóc loại nhỏ
pơm/ jang | ơpăm/ lang
lâm đắp (đắp bĭ) | bĭ | bĭ
bĭ brai | bĭ brai m | dệt vải
bĭ jang | bĭ jang | lao động
bĭ khŏm | băt khŏm | cổ gắng
bĭ sơlung | bĭ sơlung | bảo hồ
bĭ mir | bĭ mir | làm rẫy
bình | bình | làm ruộng
bĭ, găn | bĭ, găn | ngăn (ngăn dòng nước)
bơ̆jang | nglŏnang
lao động, sản xuất đục, tạc, khoét |  bŏ̂k | bŏ̂k
bri | bri
hũ, vại (cái hũ) làm việc đi
 bơ̆jang |  bliêng
 năm |  năm
 bŏ̂k găn |  bŏ̂k găn | đi qua
 bŏ̂k Trang | năm lang | tơlăm
‘nak tơ kông | bŏ̂k tơ kông | đi lên rêng. vào rừng
bơang | bơang | khoe khoang
bơbăh | bơbăh | hướng bắc
bơbrơng | bơbrơng
năm dui  xúc bùn  mái, mái nhà mái (mái như) mă hôi  rồi
bơbŭk | bơbŭk
bơbŭng | bơbŭng
c̆ơkup | pơdah
bơbuh | bơbuh
boih | bơih | bơih
boih | ôh | bơih | đâu. rồi
bơih | bơih | bơih | rồi (xong rồi)
bơih số | bơih pă | bơih pă | Tơm ban
bôk | năm | đak | đi (bước đủ | 
37