kơdih | kơdih | kơdŭ | ngại ngùng
konong | rongơng | kơđŏng | cái thúng
kơđoh | kơđoh | kơđong | vỏ (vỏ cây)
kơđôp tù | kơđôp tơ | kơđôp tơ | năm tay
kơdră hnam | kơdră hnam | kơdră hnam | chủ nhà
kơdrăt | kơdrăt | kơdrăt | vật mình
kơdrâm | kơdrâm | kơdrâm | rậm rạp
kơdu | kơdu | kơdu | chạy
kơdŭ | kơdŭ | kơdŭ | lưng
kơdŭng | tôi | tôi | túi xách
kơduêng | kơduêng | kơnguang | bóng râm
kơc̆ơ̆ | koñĭ | kơc̆ơ̆ | con rất
koh | koh | koh | chặt (chặt cây)
kơjung | kơjung | kơjung | dài, cao (><ngắn, thấp)
kok | kok | kok | trắng
kơkuh | kơkuh | kơkuh | chào
kơlang kơleng
kơlang kơleng kơleng kơne
kơlang kơleng | ngăn nhìn
kơleng
kơleng kơne
nhìn
kơlih | kơlih kơlŏ | vì vậy
kơne | yua | yua | vì, do
kơlŏ | kơlŏk | kơlŏk | hộp/cốc (cái hộp, cái là)
kơlôc̆ | kơlôc̆ | kơlôc̆ | bao giờ chết
kơmăng | kơmăng | kơmăng | buổi tối, ban đêm
kơmăp | kơmăp | kơmăp | đột quy
kơmăt | kơmăt | kơmăt | mắt, ánh mắt
kơmâng | kơmâng | kơmâng | nghe
kơmar | kơmar | kơmlat | chớp (sem chớp)
kơmil | kơmil | kơtul | gương (cái gương)
kơmlat | kơmlat | kơmlat | chớp (sem chớp)
kơmŏ | kơmŏ | kơmŏ | bẩn (đơ) | 
73