đei hơnih | đei hơnih | đei hơmŏ | có nơi
đei khui | đei khui | đei khui | có nhóm
đei kial | đei kial | đei kial | có gió
đei kơpô | đei kơpô | đei kơpô | có con trâu
đei lơ | đei lơ | đei lơ | có nhiều
đei lơ lên | đei lơ jên | đei lơ tên | có nhiêu tiên
đei mặt | đei mặt | đei mặt | có mặt
đei mĭñ pôm | đei miñ pôm | đei miñ pôm | có một cái
đei phụ | đei phụ | đei phụ | được âm nó
đei phe | đei phe | đei phe | có lúa
đei pơhrăm | đei pơhrăm | đei pơhrăm | được học hành
đei pơlei | đei pơlei | đei pơlei | có làng
đei sum | đei sum | đei sum | có kho lúa
đei hơnguong | đei tơdrong | đei tơdrong | có việc
đei iñ | đei iñ | đei ăn | có điện
đik | đĕc̆ | ăn đĕc̆ | cho không
đim | đim | đim
điểm điểm 10 | đim 10 | đim 10 | đim 10
đâng | đak | đâng | ống tông z
đak alal | đing alal | ; LEI N đing alal ; Ông sáo
đing từng | đâng tăng | đing tăng ông tre. ông 125
địa định | địa định | địa djih lưới đâm.
djrâng djrăng | hñrâng hñrăng | hñrâng hñrăng  hàng cây
đơ đak | sơlŭnt | đơđŭk vang vọng
dơhrâk | dơ hrâk | dơ hrâk _ nói dui
đak | pơre | pơre đọc
đâng noh | đâng noh | đâng noh từ đó. tơ đây
đơđik | đơđik | đơđik ngua
đơđŭk | đơđŭk | đơđŭk "ồn tiếng xe...
dơnuh | dơnuh | dơnuh nội bộ | 
50