đe đei | đe đei | đe đei | họ có
đe ga | đe ga | đe ga | họ cầm (cấm việc gì đó)
đe gô | đe gô | đe gô | họ chờ
đe hăp | đe hăp | đe hăp | họ, chúng nó
đe hơdruh | đe hơdruh | đe hơdruh | con gái, người trẻ
đe hơioh | đe hơioh | đe hơioh | trẻ em, thiếu nhi
đe jram | đângam | đe jram | họ dọn
đe kăk pam | đe kăk pam | đe kăk pam | họ đặt cái đó (cái đó là vật dụng để bắt cá)
đe khul | đe khul | đe khul | nhóm người
đe kon mon | đe kon mon | đe kon mon | con cháu
đe kră | kră | kră | người giả
đe kră sơ | đe kră sa | đe kră sa | người xưa
đe mai | đe mai | đe mai | các chị
đe muih | đe muih | đe muih | họ phát quang
đe nai | preh | preh
người khác họ nghỉ họ làm
đe pơdâi | pơdơh | pơdơh
đe pơm đe potăm | đe pơm đe pơtăm
đe pơm
đe potăm  đe pơtăm | đe pơtăm | họ trồng
đe soh | đe soh | đe soh | họ đất
đe tơnŭl | đe tơngla | đe tơnat | người lãnh đạo
đeư | rongă | đe hưc̆ | khen ngợi
ienư | đei | đe ư hơñang | người ta khen
đe ư ang | đe ư ang | đe ư ang | nổi danh
đe | đĕc̆ | đĕc̆ | thôi (cho không thôi)
đều | đẽo | điêl | dấu vết
đei | đei | đei | có, được
đei ƀar | đei ƀar | đei ƀar | có hai
đei đâng | đei đâng | đei đâng | có từ
đei đon | đei đon | đei đon | có ý tưởng | 
49