ami trung | am c̆ĕngnh | mưa đồ
ami hngac̆ | ami hngac̆ | mưa dôm
 ami prel | ami prel | ! mưa đá
 bri |  bri |  theo âm
 amĕh |  ‘moih |  muốn, thích
 amui | bruih | bụi bặm -
lăn | lăn |  cho (cho đưa)
 ăn kơ |  ăn kơ
cho, cấp, phát cho cho học, cho tập tình  rừng (măng rỡ) |  ân răm xa ană | ăn răm  hưc̆ | ‘nu  hưc̆ |  hưc̆  rừng (măng rỡ)
anăk | hanhă | đặt
anăk hơkap | anăk hơkap | uâtơẫy -
mặt | mặt | tên (tên người)
anăr dâng | ‘năr dâng | buổi trưa
anăr lĕc̆ | anăr lĕc̆ | phía đông
anăr mật | anăr mât | mặt trời lặn, phía tây
anao | anao | mới
anao lĕc̆ ang | anao lĕc̆ ang/ hơgah
chói ra
ang  ang/ hơgah | sáng, ánh sáng
ang mơnă | ang mơnat | khoe sắc
angam angam | angam angam | ngọt
anguaih | agah | ngoài (2<trong)
hơnih | anh | chỗ (chỗ ở)
anoh | anoh | đấy, đó
lu | lu | những, các (những người)
anu ang | anu ang | thế nảy, đâu đó
anu bơngai | anu bơngai | người (một người)
anu kon | anu kon | người con
anu yang | anu vang | người thần
ao | ao | áo (cái áo) | 
33