lơ | lơ | lơ | nhiều
tơhlăk | lơ hloh | tơhlăk | nhiều hơn
lơ kon | hơkăn | lơ kon | nhiêu con
lơ tơdrong | lơ tơdrong | lơ tơdrong | nhiều vần đe
lôc̆ . | luôn | luôc̆ | chết (chết chóc)
ƀôh m | lôh | lôh | ôi
gleh | anh | kah | đã (đã làm...)
loi loi
hloi | gloh loi | hơn, luôn
hloi | hloi | hơn (hơn thua)
lơi vua | lơi vua | lơi vua | lợi ích
tơhlăk . | lơlăp | lơlăp | vừa phải
lơlap | lơlap | lơlap | nhiều (rất nhiều)
lohá | hơla/ thoi lễ | lơlĕ thoi là | như là
lala | băt | băt | như đã (biết)
lơleh | lơleh | hơioh | uñ oái (từ láy)
lơlei | lơlei | lơlei | vậy
tơkơi lơlung long kreng
lơlơi lơlung
lơlơi
không có nghĩa (tơ láy) trơ trụi
lơlung lơlung long kreng long krieng
lơlung  lơlung  trơ trụi | lơlung
long krieng | loñ krieng | cây trâm
Ẵ | du | lu | đứa (một đứa) (đại chỉ chỉ định)
âu | ngại, lu đe | ngai, luộc | người (những người)
lâu | lu | TV |  những, chúng
 lu añŏng |  lu añŏng |  lu añŏng |  các anh
âu bri | IaGrôl | đe bri |  các bạn
 lu duc̆ |  lu duh | lu duh |  các cô
âu kră | lâu kră | lâu kră |  người giả
 lu kram |  lơngam |  lu kram |  giống lồ ô
lơlei | luañ |  lu họ | các anh lính (lực lượng vũ trang) | 
79