pă | pă | pă | thông gia
pă hấp | pă hăp | pô hăp | ông/bĭ thông gia của họ
pơ ñô | pơre | pơre | tiếp đãi
pơ ñô | pơ ñô | pơre | dành riêng
pơ-anam | pơ-anam | pơ-anam | siêng năng/chăm chỉ
pơangĕng . | pơangĕng | pơ năng | 4 ngóng nghe
pơđĭ c | pơđĭ | pơti | hết, hết thấy
pongâm tu . | pơđăm jơnŭt | pơđăm c̆ơt | 50 (số)
pơđăp | pođâk | jơnep | gọn gông, ngăn nắp
pođâk | pođâk | pơđăp | bản bạc
pơdăr | pơdăr | pơdăr | xung quanh
pơdah | pơdah | pơdah | soi sáng, trình chiếu, trình diện
pơdâi | pơdâi/pơlei | pơdâi/pơdơh | nghỉ ngơi
pơdâng jrăng pơdei pơdjong pođâk
pơdâng jrăng | tơ-iung trăng
dựng cột nghỉ
pơdei pơdei pơdei nghỉ pơdjong pơdjong pơangĕng tô điểm pơđăp pơđăp hnŭk trŏ chuyện
pơdei | pơdei
pơdjong
pơangĕng hnŭk | tô điểm trŏ chuyện | pođâk  pơđăp  hnŭk | pơđăp | hnŭk  trŏ chuyện
pơyông | pơyông | pơyông | làm cho nổi lên
pơdrăn | pơdrăn | pơdrăn | mồi (thức ăn cho cá, chim)
pơdrăn | pơdrăn | pơdră | tha hồ
pơdro sa | pơdro sa | pơdro sa | buôn bán
pơdrong |  pơdrong/ pơdrong | pơdrong | giàu có
 pơdreo |  pơdut | "pơdut |  bắt buộc
 pơră |  pơdŭ | ơpalũ |  luân chuyển (đồ đạc)
 pơga |  KƠKĂT | phụ AT |  bảo/ hàng rào
 pơgah |  pơgah |  tơdah |  bên, phía
 pơgang |  pơgang |  pơgang |  thuốc | 
92