ñen là | ñen là | ñen là | nhìn như, như in
năm dătŏ̂ lăng | năm năr lăng | năm đặt năng | đi tuần
năm hloi | năm hloi | năm hloi | đi ngay, đi luôn
năm rê | năm rê | năm rê | đến gần, lại gần
năm pơtơm | năm pơtơm | năm pơtơm | TV rê
năm pơtrui | năm pơtrui | năm pơtrui | hình quân
năm trong | bŏ̂k trong | đak trong | đi đường
năm tung năn dơnâu
năm tung
năm tung mặt dơnâu | đi khiêng tên của cái hồ nước | năn dơnâu mặt dơnâu  mặt dơnâu | mặt dơnâu | mặt dơnâu  tên của cái hô nước
năng | kơleng | kơleng | nhìn
năng ba | năng ba | năng ba | quan tâm
năng ngah  | năng gah | năng gah | nhìn tơ...(ngó sang...)
năng gah âu | năng gah âu | năng gah âu | nhìn bên nảy
năng oh hăp c | năng oh hăp | năng oh hăp | quan tâm người em
năng thoi | năng thoi | năng thoi | nhìn như
năr
năr ‘nao năr 16 | đất ‘năr năr 16
ngày (ngày/tháng)
‘năr năr có
‘năr  ‘năr
trời ngày 16 | năr 16  năr 16 | năr 16  năr 16 | năr là  ngày có
năr 5 | năm 5 | năr 5 | ngày
năr âu | năr âu, năm em | năr âu, năr em | hôm nay, một hôm
năr dâng | năr dâng | năr dâng | buổi trưa
năr giống | năr giống | năr giếng | ngày chủ nhật
năr gieng | năr gieng | ‘lânr gieng | ngày lễ
năr hŏk |  năr hŏk | năr hŏk | ngày học, buổi học
năr làng |  năr wă |  nar thể | ngày tốt
năr số |  năr sa |  năr sa |  ngày vui
 năr têt |  năm têt |  năr têt |  ngày tết
như tơ |  nhặt tơ |  năr tơ |  ngày nào
 năm | bŏ̂k/bôk |  năm | đi
 năm | truh |  truh | cái, đến | 
86