bum blang | bum blang | kơmi | mi gòng
ba | ba | ba | của
bĭ | bĭ | bĭ | bố (cha)
ba đak | bahnar | ba đak
lúa nước lúa vàng | ba dreng | ba dreng | ba dreng
ba jai | ba jai | ba jai | lúa sạ
ba kơpal | ba kơpal | ba kơpal | lúa ơ trên
ba puih ba sang
bahnah | ba puih | vụ chiêm
ba sang
ba sang bĭ iñ | lúa sấy... bố em | bĭ là | bĭ tơ | bĭ iñ bố em
bĭ oei | bĭ oei | bĭ oei | bố đang.... bố còn...
băt đan | băt đan | băt đan | cây bạch đon
bai | bai | bai | bài
ƀar | ƀar | ƀar | hai (số 2)
bân  bât c̆ŏng ƀar anu  bân đon
bân | bân | miệng, giọng nói
bân ống ƀar anu
bân c̆ŏng | tiếng chiêng
ƀar anu ƀar anu bân đon bân đon | ƀar anu bâng hyek
hai người tiếng cười hai phía, hai bên
bân đon  bân đon  bâng hyek | bân đon
bât hyek tiếng cười ƀar pah hai phía, hai bên | ƀar pah | ƀar pah | ƀar pah
ƀar pơyan | ƀar pơyan | ƀar pơyan | hai mùa
ƀar tơ | ƀar tơ | ƀar t | 2 cái/ hai con
bât | bật | bât | lúc (tại vị trí nào đó)
bât mum | bât mum | bât mum | góc (góc như)
bek | bek | bek | đầy (lúa đầy kho)
bóng | bóng | bóng | bánh
tih | tih | ‘mĕ̂ | con kăn
ƀlet ƀlet | ƀlet ƀlet | ƀlet ƀlet | lóng lánh
blôk | blôk | blôk | nhớ (nhớ nhung)
bŏ̂k | bŏ̂k | bŏ̂k | ông
biếm | trŏ | bốn | trúng, đụng (trúng đạn) | 
40