jang hơđơ̆ng | jang hơđơ̆ng | jang hơđơ̆ng | cố định
jang hơdrin | jang hơdrin | jang hơdrin | làm lụng
jang rah | jang rah | jang rah | tự làm
jang sa | jang sa | jang sa | làm ăn, sản xuất
jang sa kơdih | jang sa kơdih | jang sa kơdih | tự làm ăn
hlâk | kuât | hâp | khắp nơi
tập wă | lâp wă | hâp jă | tổng thể
hâp păng | hâp păng | hâp păng
khắp vùng lắm, quá, rất (đẹp lắm) | jat | at dêh | dêh
jat ei | dang ei | dang có | bây giờ
sẽ | là | rê | gần (gần xa)
jet | jet | it | hỏi
lễ đuổi | lễ đuổi | lễ đum | sắp chín
lễ mặt | lễ măt | lễ mắt | gần mắt
lễ tơ e | jĕ̂ tơ e | lễ tơ e | đến gần bạn
tên | tên
lên jet | tiên hỏi | jet | jet | jet khỏi
ưh | ưh | jih | bĭ, cạnh, ven bĭ
tih krong | tih krong | tih krong | bĭ sông. ven sông
jing | hing | ling | thành (trương thành)
hing | jing | ling | tạo thành
hing ‘mơ̆i | jing ‘mơ̆i | jing ‘mơ̆i | phát triển đã
KƠ | KƠ | tơ | giờ (đồng hồ)
joh | joh | noh/hơri | hát
rongââm | bơnôh/ sơngâm | c̆ơhngâm | làng (tâm lòng)
rongââm | jơhngâm | jơhngâm | sức (sức khỏe)
rongââm đon | rongââm đon | jơhngâm đon | vừa lòng
rongââm lặp | ngơngŏk lặp | rongââm lặp | vừa ý
rongââm pran | jơhngâm pran | jơhngâm pran | sức khỏe
rongâăm pran | jơhngâm pran | hơngugỡm pran | khỏe mạnh | 
66