jur wih |  jur wih | jur wih | quay về
ka | ka | ka | cá
ka hơla | ka hơla | ka hơla | cá ở dưới (nước)
ka là | ka là | ka là | cả nhỏ
ka phê | ka phê | ka phê | cả phê
kơdih | kơthơ | kơdih | cá to
kăk | kăk | kăk | đặt, bẫy
hrŏk | hrŏk | hrŏk | cải đơm bắt cá (loại nhỏ)
kăn | kăn | wă | con, đe
kăn | kăn | kăn | cần thiết
kăl hloh | kăl hloh | kăl hloh | hơn hết, quý hơn
kăm | kăm | kăm | thường
kăn | kăn | kăn | vợ
kăn hăp | kăn hăp | kăn hăp | vợ nó
kịp | kịp | kịp | căn
kịp giật kăt khi
kịp gặt
kịp gĭt kăt
quý giá, giá trị
mặt đất kăt khi khi kâl
mặt
cắt (cắt thịt) đầu (cái đầu) thêm khát | khi khi khi đầu (cái đầu) kăn kâl lơhing lơhing thêm khát | kâl jâp lơhing | kâl lơhing | kăn | lâl lơhing plongng | lơhing  hơngkhát
kâl angŏk | kâl angŏk | kâl angŏk | đâu óc
kâm | khoi | diĕng | kiêng cữ
kang | hang | kang | càng (ngày càng nhiều)
kang bô | kang bĭ | kang bĭ | cán bộ
kang năr | kang năr | kang năr | càng ngày càng
kao su | kao su | kao su | cao su
kĕc̆ | kĕc̆ | kết | tuốt (tuốt lúa)
keh | đang | đang | xong (hoàn thành)
kem | kem | kem | tôn
keo | keo | keo | kẹo
khan | khan | khan | gan dạ | 
68