sem nar | sem kon | sem kon | chim non
sŏk gô | sik ge | sơdrô ge | rượu gè
C̆IH | C̆IH | Sư | bảo (bảo mương)
sir hơlŭng | sir hơlŭng | sir hơlŭng | bảo hồ
so | to | so | cũ (mới)
sơ | KƠ | Sư | xưa
sơnglŏng | sơnglŏng | sơnglŏng | ngôi sao
so sơneñ Sư | so sơneñ Sư
so sơneñ | chải răng
sa  sa | số | xưa, trước đây
sŏk | sŏk | sŏk | tóc, lông
sŏk bôk | sŏk ko | sŏk ko | tóc bạc
sŏk kang | sŏk kang | sŏk kang | râu (râu ria)
sơ̆ki | ÂƠSƠ | nar sa | xế chiều
sơ̆ki | sơ̆ki | sơ̆ki | xưa kia, trước kia, ngày xưa
sa | sa | sa | ăn (ăn món ăn gì đó)
sáng | sống | sa | ăn (ăn cơm)
sống bor sáng sa phụ | sống bor sáng sa phụ | sa ngoh sáng sa phụ
ăn cơm
sáng sa phụ  sáng sa phụ | sáng sa phụ  sáng sa phụ | no nê
Sư | số/ c̆ơt | số/ hot | vui (vui vẻ)
số ană | số ană | số ang | niên vui
số hŏk | số hŏk | số hŏk | vui sướng
sa jom | sa jom | số jom | vui mừng
sa sôn | hiôk hyan | hiôk hian | hạnh phúc
sơ-angon | sơ-angon/ hơngon | sơ-angon/ hơngon | buôn
sơđâng | sơđâng | sơđâng | tơtŏ
sơgaih | sơgaih/ rơgoh | sơgaih/ rơgoh | sạch sẽ, vệ sinh
sơgaih rõ | rơgoh r | rơgoh ra | sạch đẹp
sơgâr | sơgâr | sơgâr | cái trống | 
103